xx-xx-xx-xx-xx-xx-xx-xx-xx-xx-xx-xx-xx-xx-xx-xx-xx-xx-xx-xx-xx-xx-xx-xx-xx-xx-xx-xx-xx-xx-xx-xx-xx-xx-xx-xx-xx-xx-xx-xx-xx-xx-xx-xx-xx-xx-xx-xx-xx-xx-xx-xx-xx-xx-xx-xx-xx-xx-xx-xx-xx-xx-xx-xx-xx-xx-xx-xx-xx-xx-xx-xx-xx-xx-xx-xx-xx-xx-xx-xx-xx-xx-xx-xx-xx-xx-xx-xx-xx-xx-xx-xx-xx-xx-xx-xx-xx-xx-xx-xx-xx-xx-xx-xx-xx-xx-xx-xx-xx-xx-xx-xx-xx-xx-xx-xx-xx-xx-xx-xx-xx-xx-xx-xx-xx-xx-xx-xx-xx-xx-xx-xx-xx-xx-xx-xx-xx-xx-xx-xx-xx-xx-xx-xx-xx-xx-xx-xx-xx-xx-xx-xx-xx-xx-xx-xx-xx-xx-xx-xx-xx-xx-xx-xx-xx-xx-xx-xx-xx-xx-xx-xx-xx-xx-xx-xx-xx-xx-xx-xx-xx-xx-xx-xx-xx-xx-xx-xx-xx-xx-xx-xx-xx-xx-xx-xx-xx-xx-xx-xx-xx-xx-xx-xx-xx-xx-xx-xx-xx-xx-xx-xx-xx-xx-xx-xx-xx-xx-xx-xx
xx-xx-xx-xx-xx-xx-xx-xx-xx-xx-xx-xx-xx-xx-xx-xx-xx-xx-xx-xx-xx-xx-xx-xx-xx-xx-xx-xx-xx-xx-xx-xx-xx-xx-xx-xx-xx-xx-xx-xx-xx-xx-xx-xx-xx-xx-xx-xx-xx-xx-xx-xx-xx-xx-xx-xx-xx-xx-xx-xx-xx-xx-xx-xx-xx-xx-xx-xx-xx-xx-xx-xx-xx-xx-xx-xx-xx-xx-xx-xx-xx-xx-xx-xx-xx-xx-xx-xx-xx-xx-xx-xx-xx-xx-xx-xx-xx-xx-xx-xx-xx-xx-xx-xx-xx-xx-xx-xx-xx-xx-xx-xx-xx-xx-xx-xx-xx-xx-xx-xx-xx-xx-xx-xx-xx-xx-xx-xx-xx-xx-xx-xx-xx-xx-xx-xx-xx-xx-xx-xx-xx-xx-xx-xx-xx-xx-xx-xx-xx-xx-xx-xx-xx-xx-xx-xx-xx-xx-xx-xx-xx-xx-xx-xx-xx-xx-xx-xx-xx-xx-xx-xx-xx-xx-xx-xx-xx-xx-xx-xx-xx-xx-xx-xx-xx-xx-xx-xx-xx-xx-xx-xx-xx-xx-xx-xx-xx-xx-xx-xx-xx-xx-xx-xx-xx-xx-xx-xx-xx-xx-xx-xx-xx-xx-xx-xx-xx-xx-xx-xx
xx-xx-xx-xx-xx-xx-xx-xx-xx-xx-xx-xx-xx-xx-xx-xx-xx-xx-xx-xx-xx-xx-xx-xx-xx-xx-xx-xx-xx-xx-xx-xx-xx-xx-xx-xx-xx-xx-xx-xx-xx-xx-xx-xx-xx-xx-xx-xx-xx-xx-xx-xx-xx-xx-xx-xx-xx-xx-xx-xx-xx-xx-xx-xx-xx-xx-xx-xx-xx-xx-xx-xx-xx-xx-xx-xx-xx-xx-xx-xx-xx-xx-xx-xx-xx-xx-xx-xx-xx-xx-xx-xx-xx-xx-xx-xx-xx-xx-xx-xx-xx-xx-xx-xx-xx-xx-xx-xx-xx-xx-xx-xx-xx-xx-xx-xx-xx-xx-xx-xx-xx-xx-xx-xx-xx-xx-xx-xx-xx-xx-xx-xx-xx-xx-xx-xx-xx-xx-xx-xx-xx-xx-xx-xx-xx-xx-xx-xx-xx-xx-xx-xx-xx-xx-xx-xx-xx-xx-xx-xx-xx-xx-xx-xx-xx-xx-xx-xx-xx-xx-xx-xx-xx-xx-xx-xx-xx-xx-xx-xx-xx-xx-xx-xx-xx-xx-xx-xx-xx-xx-xx-xx-xx-xx-xx-xx-xx-xx-xx-xx-xx-xx-xx-xx-xx-xx-xx-xx-xx-xx-xx-xx-xx-xx-xx-xx-xx-xx-xx-xx
xx-xx-xx-xx-xx-xx-xx-xx-xx-xx-xx-xx-xx-xx-xx-xx-xx-xx-xx-xx-xx-xx-xx-24-25-25-25-25-26-xx-xx-xx-xx-xx-xx-xx-xx-24-25-25-25-25-xx-xx-xx-xx-xx-xx-xx-xx-xx-xx-xx-xx-xx-xx-xx-xx-xx-xx-xx-xx-xx-xx-xx-xx-xx-xx-xx-xx-xx-24-25-25-25-26-xx-xx-xx-xx-xx-xx-xx-xx-xx-xx-xx-xx-xx-xx-24-25-25-25-25-25-25-25-25-25-25-25-25-26-xx-xx-xx-xx-xx-xx-xx-xx-xx-xx-xx-xx-xx-xx-xx-xx-xx-xx-xx-xx-xx-xx-xx-xx-xx-xx-24-25-25-25-25-25-26-xx-xx-xx-xx-xx-xx-xx-xx-xx-xx-xx-xx-xx-xx-xx-xx-xx-xx-xx-xx-xx-xx-xx-xx-xx-xx-xx-xx-xx-xx-xx-xx-xx-xx-xx-xx-xx-xx-xx-xx-xx-xx-xx-xx-xx-24-25-25-25-25-25-26-xx-xx-xx-xx-xx-xx-xx-xx-xx-xx-xx-xx-xx-xx-xx-xx-xx-xx-xx-xx-xx-xx-xx-xx-xx-xx-xx-xx-xx-xx-xx
xx-xx-xx-xx-xx-xx-xx-xx-xx-xx-xx-xx-xx-xx-xx-xx-xx-xx-xx-45-40-50-xx-30-31-31-31-31-31-25-25-25-25-25-25-25-25-30-31-31-31-31-xx-xx-45-40-40-40-40-40-46-40-40-46-40-40-50-xx-xx-xx-xx-xx-xx-xx-xx-xx-xx-xx-xx-xx-xx-30-31-31-31-32-xx-xx-24-25-26-xx-xx-xx-xx-xx-xx-xx-xx-xx-30-31-31-31-31-31-31-31-31-31-31-31-31-32-xx-xx-xx-xx-xx-xx-xx-xx-xx-xx-xx-xx-xx-xx-xx-xx-xx-xx-xx-xx-24-25-26-xx-xx-xx-30-52-31-31-31-31-32-xx-xx-xx-xx-xx-xx-xx-xx-xx-xx-xx-xx-xx-xx-xx-xx-xx-xx-xx-xx-xx-xx-xx-xx-xx-xx-xx-xx-xx-xx-xx-xx-xx-xx-xx-xx-xx-24-25-25-25-25-25-xx-xx-30-52-31-31-31-31-32-xx-xx-xx-xx-xx-xx-xx-xx-xx-xx-xx-xx-xx-xx-xx-xx-xx-xx-xx-xx-xx-xx-xx-xx-xx-xx-xx-xx-xx-xx-xx
xx-xx-xx-xx-xx-xx-xx-xx-xx-xx-xx-xx-xx-xx-xx-36-46-50-xx-xx-xx-xx-xx-30-31-31-31-31-31-31-31-31-31-31-31-31-31-30-31-31-31-31-xx-xx-xx-xx-xx-xx-xx-xx-xx-xx-xx-xx-xx-xx-xx-xx-xx-xx-xx-xx-xx-xx-xx-xx-xx-xx-xx-xx-xx-30-31-31-31-32-xx-xx-xx-xx-xx-xx-xx-24-25-25-25-26-xx-xx-30-31-31-31-31-31-31-31-31-31-31-31-31-32-xx-xx-xx-xx-xx-xx-xx-xx-xx-xx-xx-xx-xx-xx-xx-xx-xx-xx-xx-xx-30-31-32-xx-xx-xx-30-31-31-31-31-31-32-xx-xx-xx-xx-xx-xx-xx-xx-xx-xx-xx-xx-xx-xx-xx-xx-xx-xx-xx-xx-xx-xx-xx-xx-xx-xx-xx-xx-xx-xx-xx-xx-xx-24-26-xx-xx-33-34-34-34-34-34-xx-xx-30-31-31-31-31-31-32-xx-xx-xx-xx-xx-xx-xx-xx-xx-xx-xx-xx-xx-xx-xx-xx-xx-xx-xx-xx-xx-xx-xx-xx-xx-xx-xx-xx-xx-xx-xx
xx-xx-xx-xx-xx-xx-xx-xx-xx-xx-xx-xx-xx-xx-xx-xx-xx-xx-xx-xx-xx-xx-xx-30-31-31-31-31-31-31-31-31-31-31-31-31-31-30-31-31-31-31-xx-xx-xx-xx-xx-xx-xx-xx-xx-xx-xx-xx-xx-xx-xx-xx-xx-xx-xx-xx-24-25-25-25-25-26-xx-xx-xx-30-31-31-31-32-xx-xx-xx-xx-xx-xx-xx-33-34-34-34-35-xx-xx-30-31-31-31-31-31-31-31-31-31-31-31-31-31-25-25-25-25-25-25-25-xx-xx-xx-xx-xx-xx-xx-xx-xx-xx-xx-xx-xx-xx-xx-xx-xx-xx-xx-30-31-31-31-31-31-32-xx-xx-xx-xx-xx-xx-xx-xx-xx-xx-xx-xx-xx-xx-xx-xx-xx-xx-xx-xx-xx-xx-xx-xx-24-25-26-xx-xx-24-25-26-xx-xx-xx-xx-xx-xx-xx-xx-xx-xx-xx-xx-xx-30-31-31-31-31-31-32-24-25-25-25-25-25-25-25-25-25-25-25-25-25-25-25-xx-xx-xx-xx-xx-xx-xx-xx-xx-xx-xx-xx-xx-xx-xx
xx-xx-xx-xx-24-25-25-25-25-25-25-25-25-26-xx-xx-xx-xx-xx-xx-xx-xx-xx-30-31-31-31-31-31-31-31-31-31-31-31-31-31-30-31-31-31-31-xx-xx-xx-xx-xx-xx-xx-xx-xx-xx-xx-xx-xx-xx-xx-xx-xx-xx-xx-xx-30-31-31-31-31-32-xx-xx-xx-30-31-31-31-32-xx-xx-xx-xx-xx-xx-xx-xx-xx-xx-xx-xx-xx-xx-30-31-31-31-31-31-31-31-31-31-31-31-31-31-31-31-31-31-31-31-32-xx-xx-xx-xx-xx-xx-xx-24-25-26-xx-xx-xx-xx-xx-xx-xx-xx-xx-30-31-31-31-31-31-32-xx-xx-xx-xx-xx-xx-xx-xx-xx-xx-xx-xx-xx-xx-xx-xx-xx-xx-xx-24-25-26-xx-xx-xx-xx-xx-xx-xx-xx-xx-xx-xx-xx-xx-xx-xx-xx-xx-xx-xx-xx-xx-xx-xx-30-31-31-31-31-31-31-31-52-31-31-31-31-52-31-31-31-31-52-31-31-31-31-xx-xx-xx-xx-xx-xx-xx-xx-xx-xx-xx-xx-xx-xx-xx
xx-xx-xx-xx-30-31-31-31-31-31-31-31-31-32-xx-xx-xx-xx-xx-xx-xx-xx-xx-30-31-42-31-31-31-31-31-31-31-31-31-31-31-30-31-42-31-31-xx-xx-xx-xx-xx-xx-xx-xx-xx-xx-xx-xx-xx-xx-xx-xx-24-25-25-31-31-31-31-31-31-32-xx-xx-xx-30-31-31-31-32-xx-xx-xx-xx-xx-xx-xx-xx-xx-xx-xx-xx-xx-24-30-31-31-31-31-31-31-31-31-31-31-31-31-31-31-31-31-31-31-31-32-xx-xx-xx-xx-xx-xx-xx-30-31-32-xx-xx-xx-xx-xx-xx-xx-xx-xx-30-31-31-31-31-42-32-xx-xx-xx-xx-xx-xx-xx-xx-xx-xx-xx-xx-xx-xx-xx-xx-xx-xx-xx-30-31-32-xx-xx-xx-xx-xx-xx-xx-xx-xx-xx-xx-xx-xx-xx-xx-xx-xx-xx-xx-xx-xx-xx-xx-30-31-31-31-31-42-31-31-31-31-31-31-31-31-31-31-31-31-31-31-31-31-31-xx-xx-xx-xx-xx-xx-xx-xx-xx-xx-xx-xx-xx-xx-xx
24-25-25-25-31-31-31-31-31-31-31-31-31-25-25-25-40-25-25-25-25-25-25-31-31-31-31-31-31-31-31-31-31-31-31-31-31-31-31-31-31-31-25-25-25-25-25-25-25-25-25-25-53-31-31-31-31-31-31-31-31-31-31-31-31-31-31-31-xx-xx-xx-31-31-31-31-31-25-25-25-25-25-25-25-25-25-25-25-25-25-25-31-52-52-52-52-52-52-52-52-52-52-52-52-31-31-31-31-31-31-31-31-25-25-25-25-25-25-25-31-31-31-25-25-25-25-25-25-25-25-25-31-31-31-31-31-31-31-25-25-25-25-25-25-25-25-25-25-25-25-25-25-25-25-25-25-25-31-31-31-25-25-25-25-25-25-25-25-25-25-25-25-25-25-25-25-25-25-25-25-25-25-25-31-31-31-31-31-31-31-31-31-31-31-31-31-31-31-31-31-31-31-31-31-31-31-25-25-25-25-25-25-25-25-25-25-25-25-25-25-25
30-31-31-31-31-31-31-31-31-31-31-31-31-31-31-31-31-31-31-31-52-31-52-31-31-31-31-31-31-31-31-31-31-31-31-31-31-31-31-31-31-31-31-31-31-31-31-31-52-31-31-31-31-31-31-31-31-31-31-31-31-31-31-31-31-31-31-31-xx-xx-xx-31-31-31-31-31-31-31-31-31-31-31-31-31-31-31-31-31-31-31-31-31-31-31-31-31-31-31-31-31-31-31-31-31-31-31-31-31-31-31-31-31-42-31-31-31-31-31-31-31-31-31-31-31-31-31-31-31-31-31-31-31-31-31-31-31-31-31-31-31-31-31-31-31-31-31-31-31-31-31-31-31-31-31-31-31-31-31-31-31-31-31-31-31-31-31-31-31-31-31-31-31-31-31-31-31-31-31-31-31-31-31-31-31-31-31-31-31-31-31-31-31-31-31-31-31-31-31-31-31-31-31-31-31-31-31-31-31-31-31-31-31-31-31-31-31-31-31-31-31
30-31-31-31-31-52-31-31-31-31-31-31-31-31-31-31-31-31-31-31-31-31-31-31-42-31-31-31-31-31-31-31-31-31-31-31-31-31-31-31-31-31-31-31-31-31-31-31-31-31-31-31-31-31-31-31-31-31-31-31-31-31-31-31-31-31-31-31-xx-xx-xx-31-31-31-31-31-31-31-31-31-31-31-31-31-42-31-31-31-31-31-31-31-31-31-31-31-31-31-31-31-31-31-31-31-31-31-31-31-31-31-31-31-31-31-31-31-31-31-52-31-31-31-31-31-31-31-31-31-42-31-31-31-31-31-31-31-31-31-52-31-31-52-31-31-52-31-31-52-31-31-52-31-31-52-31-31-52-31-31-52-31-31-52-31-31-52-31-31-52-31-31-52-31-31-31-52-31-31-52-31-31-31-31-31-31-31-31-31-31-31-31-52-31-31-52-31-31-52-31-31-52-31-31-52-31-31-52-31-31-52-31-31-52-31-31-52-31-31-52-31
30-31-31-31-31-31-31-31-31-31-31-42-31-31-31-31-31-31-31-31-31-31-31-31-31-31-31-31-31-31-31-31-31-31-31-31-31-31-31-31-31-31-31-31-31-31-31-31-31-31-31-31-31-31-31-31-31-31-31-31-31-31-31-31-31-31-31-31-xx-xx-xx-31-31-31-31-31-31-31-31-31-31-31-31-31-31-31-31-31-31-31-31-31-31-31-31-31-31-31-31-31-31-31-31-31-31-52-31-31-31-31-31-31-31-31-31-31-31-31-31-31-31-31-31-31-31-31-31-31-31-31-52-31-31-31-31-31-42-31-31-31-31-31-31-31-31-31-31-31-31-31-31-31-31-31-31-31-31-31-31-31-31-31-31-31-31-31-31-31-31-31-31-31-31-31-31-31-31-31-31-31-31-31-52-31-31-31-31-31-42-31-31-31-31-31-31-31-31-31-31-31-31-31-31-31-31-31-31-31-31-31-31-31-31-31-31-31-31-31-31-31