xx-xx-xx-xx-xx-xx-xx-xx-xx-xx-xx-xx-xx-xx-xx-xx-xx-xx-xx-xx-xx-xx-xx-xx-xx-xx-xx-xx-xx-xx-xx-xx-xx-xx-xx-xx-xx-xx-xx-xx-xx-xx-xx-xx-xx-xx-xx-xx-xx-xx-xx-xx-xx-xx-xx-xx-xx-xx-xx-xx-xx-xx-xx-xx-xx-xx-xx-xx-xx-xx-xx-xx-xx-xx-xx-xx-xx-xx-xx-xx-xx-xx-xx-xx-xx-xx-xx-xx-xx-xx-xx-xx-xx-xx-xx-xx-xx-xx-xx-xx-xx-xx-xx-xx-xx-xx-xx-xx-xx-xx-xx-xx-xx-xx-xx-xx-xx-xx-xx-xx-xx-xx-xx-xx-xx-xx-xx-xx-xx-xx-xx-xx-xx-xx-xx-xx-xx-xx-xx-xx-xx-xx-xx-xx-xx-xx-xx-xx-xx-xx-xx-xx-xx-xx-xx-xx-xx
xx-xx-xx-xx-xx-xx-xx-xx-xx-xx-xx-xx-xx-xx-xx-xx-xx-xx-xx-xx-xx-xx-xx-xx-xx-xx-xx-xx-xx-xx-xx-xx-xx-xx-xx-xx-xx-xx-xx-xx-xx-xx-xx-xx-xx-xx-xx-xx-xx-xx-xx-xx-xx-xx-xx-xx-xx-xx-xx-xx-xx-xx-xx-xx-xx-xx-xx-xx-xx-xx-xx-xx-xx-xx-xx-xx-xx-xx-xx-xx-xx-xx-xx-xx-xx-xx-xx-xx-xx-xx-xx-xx-xx-xx-xx-xx-xx-xx-xx-xx-xx-xx-xx-xx-xx-xx-xx-xx-xx-xx-xx-xx-xx-xx-xx-xx-xx-xx-xx-xx-xx-xx-xx-xx-xx-xx-xx-xx-xx-xx-xx-xx-xx-xx-xx-xx-xx-xx-xx-xx-xx-xx-xx-xx-xx-xx-xx-xx-xx-xx-xx-xx-xx-xx-xx-xx-xx
xx-xx-xx-xx-xx-xx-xx-xx-xx-xx-xx-xx-xx-xx-xx-xx-xx-xx-xx-xx-xx-xx-xx-xx-xx-xx-xx-xx-xx-xx-xx-xx-xx-xx-xx-xx-xx-xx-xx-xx-xx-xx-xx-xx-xx-xx-xx-xx-xx-xx-xx-xx-xx-xx-xx-xx-xx-xx-xx-xx-xx-xx-xx-xx-xx-xx-xx-xx-xx-xx-xx-xx-xx-xx-xx-xx-xx-xx-xx-xx-xx-xx-xx-xx-xx-xx-xx-xx-xx-xx-xx-xx-xx-xx-xx-xx-xx-xx-xx-xx-xx-xx-xx-xx-xx-xx-xx-xx-xx-xx-xx-xx-xx-xx-xx-xx-xx-xx-xx-xx-xx-xx-xx-xx-xx-xx-xx-xx-xx-xx-xx-xx-xx-xx-xx-xx-xx-xx-xx-xx-xx-xx-xx-xx-xx-xx-xx-xx-xx-xx-xx-xx-xx-xx-xx-xx-xx
xx-xx-xx-xx-xx-xx-xx-xx-xx-xx-xx-xx-xx-xx-xx-xx-xx-xx-xx-xx-xx-xx-xx-xx-xx-00-01-01-01-01-02-xx-xx-xx-xx-xx-xx-xx-xx-xx-xx-xx-xx-xx-xx-xx-xx-xx-xx-xx-xx-xx-xx-xx-xx-xx-xx-xx-xx-xx-xx-xx-xx-xx-xx-xx-xx-xx-xx-xx-xx-xx-xx-xx-xx-xx-xx-xx-xx-xx-xx-xx-xx-xx-xx-xx-xx-xx-xx-00-01-01-01-02-xx-xx-xx-xx-xx-xx-xx-xx-xx-xx-xx-xx-xx-xx-xx-xx-xx-xx-xx-xx-xx-xx-xx-xx-xx-xx-xx-xx-xx-xx-xx-xx-xx-xx-xx-xx-xx-xx-xx-xx-xx-xx-xx-xx-xx-xx-xx-xx-xx-xx-xx-xx-xx-xx-xx-xx-xx-xx-xx-xx-xx-xx-xx
xx-xx-xx-xx-xx-xx-xx-xx-xx-xx-xx-52-53-53-54-xx-xx-xx-52-53-54-xx-xx-xx-xx-03-04-04-04-04-05-xx-xx-xx-xx-xx-xx-xx-xx-xx-xx-xx-xx-xx-xx-xx-xx-xx-xx-xx-xx-xx-xx-xx-xx-xx-xx-xx-xx-xx-xx-xx-xx-xx-52-53-54-xx-xx-xx-xx-xx-52-53-53-53-53-54-xx-xx-xx-xx-xx-52-53-54-xx-xx-xx-03-04-04-04-05-xx-xx-xx-xx-xx-xx-52-53-53-54-xx-xx-xx-xx-52-54-xx-xx-xx-xx-xx-xx-xx-xx-xx-xx-xx-xx-xx-xx-xx-xx-xx-xx-xx-xx-xx-xx-xx-xx-xx-xx-xx-00-01-02-xx-xx-xx-xx-xx-xx-00-01-01-01-01-01-01-01-01-01-02
xx-xx-xx-xx-xx-xx-xx-xx-xx-xx-xx-xx-xx-xx-xx-xx-xx-xx-xx-xx-xx-xx-xx-xx-xx-03-04-04-04-04-05-xx-xx-xx-xx-xx-xx-xx-xx-xx-xx-xx-xx-xx-xx-xx-xx-xx-xx-xx-xx-xx-xx-xx-xx-xx-xx-xx-xx-xx-xx-xx-xx-xx-xx-xx-xx-xx-xx-xx-xx-xx-xx-xx-xx-xx-xx-xx-xx-xx-xx-xx-xx-xx-xx-xx-xx-xx-xx-03-04-04-04-05-xx-xx-xx-xx-xx-xx-xx-xx-xx-xx-xx-xx-xx-xx-xx-xx-xx-xx-xx-xx-xx-xx-xx-xx-xx-xx-xx-xx-xx-xx-xx-xx-xx-xx-xx-xx-xx-xx-xx-xx-xx-xx-xx-06-07-10-xx-xx-xx-xx-xx-xx-03-04-04-04-04-04-04-04-04-04-05
xx-xx-xx-xx-xx-xx-xx-xx-xx-xx-xx-xx-xx-xx-xx-xx-xx-xx-xx-xx-xx-xx-xx-xx-xx-03-04-04-04-04-56-01-01-01-01-01-01-02-xx-xx-xx-xx-xx-xx-xx-xx-xx-xx-xx-xx-xx-xx-xx-xx-xx-xx-xx-00-01-02-xx-xx-xx-xx-xx-xx-xx-xx-xx-xx-xx-xx-xx-xx-xx-xx-xx-xx-xx-xx-xx-xx-xx-xx-xx-xx-xx-xx-xx-03-04-04-04-05-xx-xx-xx-xx-xx-xx-xx-xx-xx-xx-xx-xx-xx-xx-xx-xx-xx-xx-xx-xx-xx-xx-xx-xx-xx-xx-xx-xx-xx-xx-xx-xx-xx-xx-xx-xx-xx-xx-xx-xx-xx-xx-xx-xx-xx-xx-xx-xx-xx-xx-xx-xx-03-04-04-04-04-04-04-04-04-04-05
xx-xx-xx-xx-00-01-02-xx-xx-xx-xx-xx-xx-xx-xx-xx-xx-xx-xx-xx-xx-xx-xx-xx-xx-03-04-04-04-04-04-04-04-04-04-04-04-05-xx-xx-xx-xx-xx-xx-xx-xx-xx-xx-xx-xx-xx-xx-xx-xx-xx-xx-xx-03-04-05-xx-xx-xx-xx-xx-xx-xx-xx-xx-xx-xx-xx-xx-xx-xx-xx-xx-xx-xx-xx-xx-xx-xx-xx-xx-xx-xx-xx-xx-03-04-04-04-05-xx-xx-xx-xx-xx-xx-xx-xx-xx-xx-xx-xx-xx-xx-xx-xx-xx-xx-xx-00-01-02-xx-xx-xx-xx-xx-xx-xx-xx-xx-xx-xx-xx-xx-xx-00-01-02-xx-xx-xx-xx-xx-xx-xx-xx-xx-xx-xx-xx-xx-03-04-04-04-04-04-04-04-04-04-05
xx-xx-xx-xx-03-04-05-xx-xx-xx-xx-xx-xx-xx-xx-xx-xx-xx-xx-xx-xx-xx-xx-xx-xx-03-04-04-04-04-04-04-04-04-04-04-04-56-01-01-01-01-01-01-01-01-01-01-01-01-01-01-01-01-01-01-01-55-04-05-xx-xx-xx-xx-xx-xx-xx-xx-xx-xx-xx-xx-xx-xx-xx-xx-xx-xx-xx-xx-xx-xx-xx-xx-xx-xx-xx-xx-xx-03-04-04-04-05-xx-xx-xx-xx-xx-xx-xx-xx-xx-xx-xx-xx-xx-xx-xx-xx-xx-xx-xx-03-04-05-xx-xx-xx-xx-xx-xx-xx-xx-xx-xx-xx-xx-xx-xx-03-04-05-xx-xx-xx-xx-xx-xx-xx-xx-xx-xx-xx-xx-xx-03-04-04-04-04-04-04-04-04-04-05
00-01-01-01-55-04-56-01-01-01-01-01-01-01-01-01-01-01-01-01-01-01-01-01-01-55-04-04-04-04-04-04-04-04-04-04-04-04-04-04-04-04-04-04-04-04-04-04-04-04-04-04-04-04-04-04-04-04-04-56-01-01-01-01-01-01-01-01-01-01-01-01-01-01-01-01-01-01-01-01-01-01-01-01-01-01-01-01-01-55-04-04-04-56-01-01-01-01-01-01-01-01-01-01-01-01-01-01-01-01-01-01-01-55-04-56-01-01-01-01-01-01-01-01-01-01-01-01-01-01-55-04-56-01-01-01-01-01-01-01-01-01-01-01-01-01-55-04-04-04-04-04-04-04-04-04-05
03-04-04-04-04-04-04-04-04-04-04-04-04-04-04-04-04-04-04-04-04-04-04-04-04-04-04-04-04-04-04-04-04-04-04-04-04-04-04-04-04-04-04-04-04-04-04-04-04-04-04-04-04-04-04-04-04-04-04-04-04-04-04-04-04-04-04-04-04-04-04-04-04-04-04-04-04-04-04-04-04-04-04-04-04-04-04-04-04-04-04-04-04-04-04-04-04-04-04-04-04-04-04-04-04-04-04-04-04-04-04-04-04-04-04-04-04-04-04-04-04-04-04-04-04-04-04-04-04-04-04-04-04-04-04-04-04-04-04-04-04-04-04-04-04-04-04-04-04-04-04-04-04-04-04-04-05
03-04-04-04-04-04-04-04-04-04-04-04-04-04-04-04-04-04-04-04-04-04-04-04-04-04-04-04-04-04-04-04-04-04-04-04-04-04-04-04-04-04-04-04-04-04-04-04-04-04-04-04-04-04-04-04-04-04-04-04-04-04-04-04-04-04-04-04-04-04-04-04-04-04-04-04-04-04-04-04-04-04-04-04-04-04-04-04-04-04-04-04-04-04-04-04-04-04-04-04-04-04-04-04-04-04-04-04-04-04-04-04-04-04-04-04-04-04-04-04-04-04-04-04-04-04-04-04-04-04-04-04-04-04-04-04-04-04-04-04-04-04-04-04-04-04-04-04-04-04-04-04-04-04-04-04-05
03-04-04-04-04-04-04-04-04-04-04-04-04-04-04-04-04-04-04-04-04-04-04-04-04-04-04-04-04-04-04-04-04-04-04-04-04-04-04-04-04-04-04-04-04-04-04-04-04-04-04-04-04-04-04-04-04-04-04-04-04-04-04-04-04-04-04-04-04-04-04-04-04-04-04-04-04-04-04-04-04-04-04-04-04-04-04-04-04-04-04-04-04-04-04-04-04-04-04-04-04-04-04-04-04-04-04-04-04-04-04-04-04-04-04-04-04-04-04-04-04-04-04-04-04-04-04-04-04-04-04-04-04-04-04-04-04-04-04-04-04-04-04-04-04-04-04-04-04-04-04-04-04-04-04-04-05