xx-xx-xx-xx-xx-xx-xx-xx-xx-xx-xx-xx-xx-xx-xx-xx-xx-xx-xx-xx-xx-xx-xx-xx-xx-xx-xx-xx-xx-xx-xx-xx-xx-xx-xx-xx-xx-xx-xx-xx-xx-xx-xx-xx-xx-xx-xx-xx-xx-xx-xx-xx-xx-xx-xx-xx-xx-xx-xx-xx-xx-xx-xx-xx-xx-xx-xx-xx-xx-xx-xx-xx-xx-xx-xx-xx-xx-xx-xx-xx-xx-xx-xx-xx-xx-xx-xx-xx-xx-xx-xx-xx-xx-xx-xx-xx-xx-xx-xx-xx-xx-xx-xx-xx-xx-xx-xx-xx-xx-xx-xx-xx-xx-xx-xx-xx-xx-xx-xx-xx-xx-xx-xx-xx-xx-xx-xx-xx-xx-xx-xx-xx-xx-xx-xx-xx-xx-xx-xx-xx-xx-xx-xx-xx-xx-xx-xx-xx-xx-xx-xx-xx-xx-xx-xx-xx-xx-xx-xx-xx-xx-xx-xx-xx-xx-xx-xx-xx-xx-xx-xx-xx-xx-xx-xx-xx-xx-xx-xx-xx-xx-xx-xx-xx-xx-xx-xx-xx-xx-xx-xx-xx-xx-xx-xx-xx-xx-xx-xx-xx-xx-xx-xx-xx-xx-xx-xx-xx-xx-xx-xx-xx-xx-xx-xx-xx-xx-xx-xx-xx-xx-xx-xx-xx-xx-xx-xx-xx-xx-xx-xx-xx-xx-xx
xx-xx-xx-xx-xx-xx-xx-xx-xx-xx-xx-xx-xx-xx-xx-xx-xx-xx-xx-xx-xx-xx-xx-xx-xx-xx-xx-xx-xx-xx-xx-xx-xx-xx-xx-xx-xx-xx-xx-xx-xx-xx-xx-xx-xx-xx-xx-xx-xx-xx-xx-xx-xx-xx-xx-xx-xx-xx-xx-xx-xx-xx-xx-xx-xx-xx-xx-xx-xx-xx-xx-xx-xx-xx-xx-xx-xx-xx-xx-xx-xx-xx-xx-xx-xx-xx-xx-xx-xx-xx-xx-xx-xx-xx-xx-xx-xx-xx-xx-xx-xx-xx-xx-xx-xx-xx-xx-xx-xx-xx-xx-xx-xx-xx-xx-xx-xx-xx-xx-xx-xx-xx-xx-xx-xx-xx-xx-xx-xx-xx-xx-xx-xx-xx-xx-xx-xx-xx-xx-xx-xx-xx-xx-xx-xx-xx-xx-xx-xx-xx-xx-xx-xx-xx-xx-xx-xx-xx-xx-xx-xx-xx-xx-xx-xx-xx-xx-xx-xx-xx-xx-xx-xx-xx-xx-xx-xx-xx-xx-xx-xx-xx-xx-xx-xx-xx-xx-xx-xx-xx-xx-xx-xx-xx-xx-xx-xx-xx-xx-xx-xx-xx-xx-xx-xx-xx-xx-xx-xx-xx-xx-xx-xx-xx-xx-xx-xx-xx-xx-xx-xx-xx-xx-xx-xx-xx-xx-xx-xx-xx-xx-xx-xx-xx
xx-xx-xx-xx-xx-xx-xx-xx-xx-xx-xx-xx-xx-xx-xx-xx-xx-xx-xx-xx-xx-xx-xx-xx-xx-xx-xx-xx-xx-xx-xx-xx-xx-xx-xx-xx-xx-xx-xx-xx-xx-xx-xx-xx-xx-xx-xx-xx-xx-xx-xx-xx-xx-xx-xx-xx-xx-xx-xx-xx-xx-xx-xx-xx-xx-xx-xx-xx-xx-xx-xx-xx-xx-xx-xx-xx-xx-xx-xx-xx-xx-xx-xx-xx-xx-xx-xx-xx-xx-xx-xx-xx-xx-xx-xx-xx-xx-xx-xx-xx-xx-xx-xx-xx-xx-xx-xx-xx-xx-xx-xx-xx-xx-xx-xx-xx-xx-xx-xx-xx-xx-xx-xx-xx-xx-xx-xx-xx-xx-xx-xx-xx-xx-xx-xx-xx-xx-xx-xx-xx-xx-xx-xx-xx-xx-xx-xx-xx-xx-xx-xx-xx-xx-xx-xx-xx-xx-xx-xx-xx-xx-xx-xx-xx-xx-xx-xx-xx-xx-xx-xx-xx-xx-xx-xx-xx-xx-xx-xx-xx-xx-xx-xx-xx-xx-xx-xx-xx-xx-xx-xx-xx-xx-xx-xx-xx-xx-xx-xx-xx-xx-xx-xx-xx-xx-xx-xx-xx-xx-xx-xx-xx-xx-xx-xx-xx-xx-xx-xx-xx-xx-xx-xx-xx-xx-xx-xx-xx-xx-xx-xx-xx-xx-xx
xx-xx-xx-xx-xx-xx-xx-xx-xx-xx-xx-xx-xx-xx-xx-xx-xx-xx-xx-xx-xx-xx-xx-xx-xx-xx-11-13-xx-xx-xx-xx-xx-xx-xx-xx-xx-xx-xx-xx-xx-xx-xx-xx-xx-xx-xx-xx-xx-xx-xx-xx-xx-xx-xx-xx-xx-xx-xx-xx-xx-xx-xx-xx-xx-xx-xx-xx-xx-xx-xx-xx-xx-xx-xx-xx-xx-xx-xx-57-61-61-61-61-61-61-61-61-61-61-60-xx-xx-xx-xx-xx-xx-11-12-12-12-12-12-12-12-12-13-xx-xx-xx-xx-xx-xx-xx-xx-xx-xx-xx-xx-xx-xx-xx-xx-xx-xx-xx-xx-xx-xx-xx-xx-xx-xx-xx-xx-xx-xx-xx-xx-xx-xx-xx-xx-xx-xx-xx-xx-xx-xx-xx-xx-xx-xx-xx-xx-xx-xx-xx-xx-xx-xx-xx-xx-xx-xx-xx-xx-xx-xx-xx-xx-xx-xx-xx-xx-xx-xx-xx-xx-xx-xx-xx-xx-xx-xx-xx-xx-xx-xx-xx-xx-xx-xx-xx-xx-xx-xx-xx-xx-xx-xx-xx-xx-xx-xx-xx-xx-xx-xx-xx-xx-xx-xx-xx-xx-xx-xx-xx-xx-xx-xx-xx-xx-xx-xx-xx-xx-xx-xx-xx-xx-xx-xx-xx
xx-xx-xx-xx-xx-xx-xx-xx-xx-xx-xx-xx-xx-xx-xx-xx-57-61-60-xx-xx-xx-xx-57-61-61-20-21-xx-xx-xx-xx-11-12-12-12-12-12-12-13-xx-xx-xx-xx-xx-xx-xx-xx-xx-xx-xx-xx-xx-xx-57-61-61-61-61-61-61-60-xx-xx-xx-xx-xx-xx-57-61-61-61-61-60-xx-xx-xx-xx-xx-xx-xx-xx-xx-xx-xx-xx-xx-xx-xx-xx-xx-xx-xx-xx-xx-xx-xx-14-15-15-15-15-15-15-15-15-16-xx-xx-xx-xx-xx-xx-xx-xx-57-61-61-61-61-60-xx-xx-xx-xx-xx-xx-xx-xx-xx-xx-xx-xx-xx-xx-xx-xx-xx-xx-xx-xx-xx-xx-xx-xx-xx-xx-xx-xx-xx-xx-xx-11-12-12-12-12-12-12-13-xx-xx-xx-xx-xx-xx-xx-xx-xx-xx-xx-xx-xx-57-61-61-61-61-61-61-61-61-61-61-61-61-61-61-61-61-61-60-xx-xx-xx-xx-11-12-12-12-13-xx-xx-xx-xx-57-61-60-xx-xx-xx-xx-xx-xx-xx-xx-xx-xx-xx-xx-xx-xx-xx-11-12-12-12-12-12-12-12-12-12-12
xx-xx-xx-xx-xx-xx-xx-xx-xx-xx-xx-xx-xx-xx-xx-xx-xx-xx-xx-xx-xx-xx-xx-xx-xx-xx-xx-xx-xx-xx-xx-xx-14-15-15-15-15-15-15-16-xx-xx-xx-xx-xx-xx-xx-xx-xx-xx-xx-xx-xx-xx-xx-xx-xx-xx-xx-xx-xx-xx-xx-xx-xx-xx-xx-xx-xx-xx-xx-xx-xx-xx-xx-xx-xx-xx-xx-xx-xx-xx-xx-xx-xx-xx-xx-xx-xx-xx-xx-xx-xx-xx-xx-xx-xx-14-15-15-15-15-15-15-15-15-16-xx-xx-xx-xx-xx-xx-xx-xx-xx-xx-xx-xx-xx-xx-xx-xx-xx-xx-57-61-61-61-60-xx-xx-xx-xx-xx-xx-xx-xx-xx-xx-xx-xx-xx-xx-xx-xx-xx-xx-xx-xx-xx-xx-17-20-20-20-20-20-20-21-xx-xx-xx-xx-57-61-61-61-60-xx-xx-xx-xx-xx-xx-xx-xx-xx-xx-xx-xx-xx-xx-xx-xx-xx-xx-xx-xx-xx-xx-xx-xx-xx-xx-xx-17-20-20-20-21-xx-xx-xx-xx-xx-xx-xx-xx-xx-xx-xx-xx-xx-xx-11-12-12-12-12-12-12-12-62-15-15-15-15-15-15-15-15-15-16
xx-xx-xx-xx-xx-xx-xx-xx-xx-xx-11-13-xx-xx-xx-xx-xx-xx-xx-xx-xx-xx-xx-xx-xx-xx-xx-xx-xx-xx-xx-xx-14-15-15-15-15-15-15-63-12-12-12-12-12-12-12-12-12-13-xx-xx-xx-xx-xx-xx-xx-xx-xx-xx-xx-xx-xx-xx-xx-xx-xx-xx-xx-xx-xx-xx-xx-xx-xx-xx-xx-xx-xx-xx-xx-xx-xx-xx-xx-xx-xx-xx-xx-xx-xx-xx-xx-xx-xx-xx-xx-14-15-15-15-15-15-15-15-15-16-xx-xx-xx-xx-xx-xx-xx-xx-xx-xx-xx-xx-xx-xx-xx-xx-xx-xx-xx-xx-xx-xx-xx-xx-xx-xx-xx-xx-xx-xx-xx-11-12-12-12-12-12-12-12-12-13-xx-xx-xx-xx-xx-xx-xx-xx-xx-xx-xx-xx-xx-xx-xx-xx-xx-xx-xx-xx-xx-xx-xx-xx-xx-xx-xx-xx-xx-xx-xx-xx-xx-xx-xx-xx-xx-xx-xx-xx-xx-xx-xx-xx-xx-xx-xx-xx-xx-xx-xx-xx-xx-xx-xx-xx-xx-xx-xx-xx-xx-xx-xx-xx-xx-xx-xx-14-15-15-15-15-15-15-15-15-15-15-15-15-15-15-15-15-15-16
xx-xx-xx-xx-xx-xx-xx-11-12-12-62-16-xx-xx-xx-xx-xx-xx-xx-xx-xx-xx-xx-xx-xx-xx-xx-xx-xx-xx-xx-xx-14-15-15-15-15-15-15-15-15-15-15-15-15-15-15-15-15-16-xx-xx-xx-xx-xx-xx-xx-xx-xx-xx-xx-xx-xx-xx-xx-xx-xx-xx-xx-xx-xx-xx-xx-xx-xx-xx-xx-11-12-13-xx-xx-xx-xx-xx-xx-xx-xx-xx-xx-xx-xx-xx-xx-xx-xx-xx-14-15-15-15-15-15-15-15-15-16-xx-xx-xx-xx-xx-xx-xx-xx-xx-xx-xx-xx-xx-xx-xx-xx-xx-xx-xx-xx-xx-xx-xx-xx-xx-xx-xx-xx-11-12-12-62-15-15-15-15-15-15-15-15-16-xx-xx-xx-xx-xx-xx-xx-xx-xx-xx-xx-xx-xx-xx-xx-xx-xx-xx-xx-xx-xx-xx-xx-xx-xx-xx-xx-xx-xx-xx-xx-xx-xx-xx-xx-xx-xx-xx-xx-xx-xx-xx-xx-xx-xx-xx-xx-xx-xx-xx-xx-xx-xx-xx-xx-xx-xx-xx-xx-xx-xx-xx-xx-xx-11-12-12-62-15-15-15-15-15-15-15-15-15-15-15-15-15-15-15-15-15-16
xx-xx-xx-xx-xx-xx-xx-14-15-15-15-16-xx-xx-xx-xx-xx-xx-xx-xx-xx-xx-xx-xx-xx-xx-xx-xx-xx-xx-xx-xx-14-15-15-15-15-15-15-15-15-15-15-15-15-15-15-15-15-63-12-12-12-12-12-12-12-12-12-12-xx-xx-xx-xx-xx-xx-xx-xx-xx-xx-xx-xx-xx-xx-xx-xx-xx-14-15-16-xx-xx-xx-xx-xx-xx-xx-xx-xx-xx-xx-xx-xx-xx-xx-xx-xx-14-15-15-15-15-15-15-15-15-16-xx-xx-xx-xx-xx-xx-xx-xx-xx-xx-xx-xx-xx-xx-xx-xx-xx-xx-xx-xx-xx-xx-xx-xx-xx-xx-xx-xx-14-15-15-15-15-15-15-15-15-15-15-15-16-xx-xx-xx-xx-xx-xx-xx-xx-xx-xx-xx-xx-xx-xx-xx-xx-xx-xx-xx-xx-xx-xx-xx-xx-xx-xx-xx-xx-xx-xx-xx-xx-xx-xx-xx-xx-xx-xx-xx-xx-xx-xx-xx-xx-xx-xx-xx-xx-xx-xx-xx-xx-xx-xx-xx-xx-xx-xx-xx-xx-xx-xx-xx-xx-14-15-15-15-15-15-15-15-15-15-15-15-15-15-15-15-15-15-15-15-15-16
11-12-12-12-12-12-12-62-15-15-15-63-12-12-12-12-12-12-12-12-12-12-12-12-12-12-12-12-12-12-12-12-62-15-15-15-15-15-15-15-15-15-15-15-15-15-15-15-15-15-15-15-15-15-15-15-15-15-15-63-12-12-12-12-12-12-12-12-12-12-12-12-12-12-12-12-12-62-15-63-12-12-12-12-12-12-12-12-12-12-12-12-12-12-12-12-12-62-15-15-15-15-15-15-15-15-16-xx-xx-xx-xx-xx-xx-12-12-12-12-12-12-12-12-12-12-12-12-12-12-12-12-12-12-12-12-12-12-62-15-15-15-15-15-15-15-15-15-15-15-63-12-12-12-12-12-12-12-12-12-12-12-12-12-12-12-12-12-12-12-12-12-12-12-12-12-12-12-12-12-12-12-12-12-12-12-12-12-12-12-12-12-12-12-12-12-12-12-12-12-12-12-12-12-12-12-12-12-12-12-12-12-12-12-12-62-15-15-15-15-15-15-15-15-15-15-15-15-15-15-15-15-15-15-15-15-16
14-15-15-15-15-15-15-15-15-15-15-15-15-15-15-15-15-15-15-15-15-15-15-15-15-15-15-15-15-15-15-15-15-15-15-15-15-15-15-15-15-15-15-15-15-15-15-15-15-15-15-15-15-15-15-15-15-15-15-15-15-15-15-15-15-15-15-15-15-15-15-15-15-15-15-15-15-15-15-15-15-15-15-15-15-15-15-15-15-15-15-15-15-15-15-15-15-15-15-15-15-15-15-15-15-15-16-xx-xx-xx-xx-xx-xx-15-15-15-15-15-15-15-15-15-15-15-15-15-15-15-15-15-15-15-15-15-15-15-15-15-15-15-15-15-15-15-15-15-15-15-15-15-15-15-15-15-15-15-15-15-15-15-15-15-15-15-15-15-15-15-15-15-15-15-15-15-15-15-15-15-15-15-15-15-15-15-15-15-15-15-15-15-15-15-15-15-15-15-15-15-15-15-15-15-15-15-15-15-15-15-15-15-15-15-15-15-15-15-15-15-15-15-15-15-15-15-15-15-15-15-15-15-15-15-15-16
14-15-15-15-15-15-15-15-15-15-15-15-15-15-15-15-15-15-15-15-15-15-15-15-15-15-15-15-15-15-15-15-15-15-15-15-15-15-15-15-15-15-15-15-15-15-15-15-15-15-15-15-15-15-15-15-15-15-15-15-15-15-15-15-15-15-15-15-15-15-15-15-15-15-15-15-15-15-15-15-15-15-15-15-15-15-15-15-15-15-15-15-15-15-15-15-15-15-15-15-15-15-15-15-15-15-16-xx-xx-xx-xx-xx-xx-15-15-15-15-15-15-15-15-15-15-15-15-15-15-15-15-15-15-15-15-15-15-15-15-15-15-15-15-15-15-15-15-15-15-15-15-15-15-15-15-15-15-15-15-15-15-15-15-15-15-15-15-15-15-15-15-15-15-15-15-15-15-15-15-15-15-15-15-15-15-15-15-15-15-15-15-15-15-15-15-15-15-15-15-15-15-15-15-15-15-15-15-15-15-15-15-15-15-15-15-15-15-15-15-15-15-15-15-15-15-15-15-15-15-15-15-15-15-15-15-16
14-15-15-15-15-15-15-15-15-15-15-15-15-15-15-15-15-15-15-15-15-15-15-15-15-15-15-15-15-15-15-15-15-15-15-15-15-15-15-15-15-15-15-15-15-15-15-15-15-15-15-15-15-15-15-15-15-15-15-15-15-15-15-15-15-15-15-15-15-15-15-15-15-15-15-15-15-15-15-15-15-15-15-15-15-15-15-15-15-15-15-15-15-15-15-15-15-15-15-15-15-15-15-15-15-15-16-xx-xx-xx-xx-xx-xx-15-15-15-15-15-15-15-15-15-15-15-15-15-15-15-15-15-15-15-15-15-15-15-15-15-15-15-15-15-15-15-15-15-15-15-15-15-15-15-15-15-15-15-15-15-15-15-15-15-15-15-15-15-15-15-15-15-15-15-15-15-15-15-15-15-15-15-15-15-15-15-15-15-15-15-15-15-15-15-15-15-15-15-15-15-15-15-15-15-15-15-15-15-15-15-15-15-15-15-15-15-15-15-15-15-15-15-15-15-15-15-15-15-15-15-15-15-15-15-15-16                                                                                                                                                                                                                                                        