xx-xx-xx-xx-xx-xx-xx-xx-xx-xx-xx-xx-xx-xx-xx-xx-xx-xx-xx-xx-xx-xx-xx-xx-xx-xx-xx-xx-xx-xx-xx-xx-xx-xx-xx-xx-xx-xx-xx-xx-xx-xx-xx-xx-xx-xx-xx-xx-xx-xx-xx-xx-xx-xx-xx-xx-xx-xx-xx-xx-xx-xx-xx-xx-xx-xx-xx-xx-xx-xx-xx-xx-xx-xx-xx-xx-xx-xx-xx-xx-xx-xx-xx-xx-xx-xx-xx-xx-xx-xx-xx-xx-xx-xx-xx-xx-xx-xx-xx-xx-xx-xx-xx-xx-xx-xx-xx-xx-xx-xx-xx-xx-xx-xx-xx-xx-xx-xx-xx-xx-xx-xx-xx-xx-xx-xx-xx-xx-xx-xx-xx-xx-xx-xx-xx-xx-xx-xx-xx-xx-xx-xx-xx-xx-xx-xx-xx-xx-xx-xx-xx-xx-xx-xx-xx-xx-xx-xx-xx-xx-xx-xx-xx-xx-xx-xx-xx-xx-xx-xx-xx-xx-xx-xx-xx-xx-xx-xx-xx-xx-xx-xx-xx-xx-xx-xx-xx-xx-xx-xx-xx-xx-xx-xx-xx-xx-xx-xx-xx-xx-xx-xx-xx-xx-xx-xx-xx-xx-xx-xx-xx-xx-xx-xx-xx-xx-xx-xx-xx-xx
xx-xx-xx-xx-xx-xx-xx-xx-xx-xx-xx-xx-xx-xx-xx-xx-xx-xx-xx-xx-xx-xx-xx-xx-xx-xx-xx-xx-xx-xx-xx-xx-xx-xx-xx-xx-xx-xx-xx-xx-xx-xx-xx-xx-xx-xx-xx-xx-xx-xx-xx-xx-xx-xx-xx-xx-xx-xx-xx-xx-xx-xx-xx-xx-xx-xx-xx-xx-xx-xx-xx-xx-xx-xx-xx-xx-xx-xx-xx-xx-xx-xx-xx-xx-xx-xx-xx-xx-xx-xx-xx-xx-xx-xx-xx-xx-xx-xx-xx-xx-xx-xx-xx-xx-xx-xx-xx-xx-xx-xx-xx-xx-xx-xx-xx-xx-xx-xx-xx-xx-xx-xx-xx-xx-xx-xx-xx-xx-xx-xx-xx-xx-xx-xx-xx-xx-xx-xx-xx-xx-xx-xx-xx-xx-xx-xx-xx-xx-xx-xx-xx-xx-xx-xx-xx-xx-xx-xx-xx-xx-xx-xx-xx-xx-xx-xx-xx-xx-xx-xx-xx-xx-xx-xx-xx-xx-xx-xx-xx-xx-xx-xx-xx-xx-xx-xx-xx-xx-xx-xx-xx-xx-xx-xx-xx-xx-xx-xx-xx-xx-xx-xx-xx-xx-xx-xx-xx-xx-xx-xx-xx-xx-xx-xx-xx-xx-xx-xx-xx-xx
xx-xx-xx-xx-xx-xx-xx-xx-xx-xx-xx-xx-xx-xx-xx-xx-xx-xx-xx-xx-xx-xx-xx-xx-xx-xx-xx-xx-xx-xx-xx-xx-xx-xx-xx-xx-xx-xx-xx-xx-xx-xx-xx-xx-xx-xx-xx-xx-xx-xx-xx-xx-xx-xx-xx-xx-xx-xx-xx-xx-xx-xx-xx-xx-xx-xx-xx-xx-xx-xx-xx-xx-xx-xx-xx-xx-xx-xx-xx-xx-xx-xx-xx-xx-xx-xx-xx-xx-xx-xx-xx-xx-xx-xx-xx-xx-xx-xx-xx-xx-xx-xx-xx-xx-xx-xx-xx-xx-xx-xx-xx-xx-xx-xx-xx-xx-xx-xx-xx-xx-xx-xx-xx-xx-xx-xx-xx-xx-xx-xx-xx-xx-xx-xx-xx-xx-xx-xx-xx-xx-xx-xx-xx-xx-xx-xx-xx-xx-xx-xx-xx-xx-xx-xx-xx-xx-xx-xx-xx-xx-xx-xx-xx-xx-xx-xx-xx-xx-xx-xx-xx-xx-xx-xx-xx-xx-xx-xx-xx-xx-xx-xx-xx-xx-xx-xx-xx-xx-xx-xx-xx-xx-xx-xx-xx-xx-xx-xx-xx-xx-xx-xx-xx-xx-xx-xx-xx-xx-xx-xx-xx-xx-xx-xx-xx-xx-xx-xx-xx-xx
xx-xx-xx-xx-xx-xx-xx-xx-xx-xx-xx-xx-xx-xx-xx-xx-xx-xx-xx-xx-xx-xx-xx-22-23-23-23-23-24-xx-xx-xx-xx-xx-xx-xx-xx-22-23-23-23-24-xx-xx-xx-xx-xx-xx-xx-xx-xx-xx-xx-xx-xx-xx-xx-xx-xx-xx-xx-xx-xx-xx-xx-xx-xx-xx-xx-xx-xx-22-23-23-23-24-xx-xx-xx-xx-xx-xx-xx-xx-xx-xx-xx-xx-xx-xx-22-23-23-23-23-23-23-23-23-23-23-23-23-24-xx-xx-xx-xx-xx-xx-xx-xx-xx-xx-xx-xx-xx-xx-xx-xx-xx-xx-xx-xx-xx-xx-xx-xx-xx-xx-22-23-23-23-23-23-24-xx-xx-xx-xx-xx-xx-xx-xx-xx-xx-xx-xx-xx-xx-xx-xx-xx-xx-xx-xx-xx-xx-xx-xx-xx-xx-xx-xx-xx-xx-xx-xx-xx-xx-xx-xx-xx-xx-xx-xx-xx-xx-xx-xx-xx-22-23-23-23-23-23-24-xx-xx-xx-xx-xx-xx-xx-xx-xx-xx-xx-xx-xx-xx-xx-xx-xx-xx-xx-xx-xx-xx-xx-xx-xx-xx-xx-xx-xx-xx-xx
xx-xx-xx-xx-xx-xx-xx-xx-xx-xx-xx-xx-xx-xx-xx-xx-xx-xx-xx-66-65-70-xx-25-26-26-26-26-72-23-23-23-23-23-23-23-23-71-26-26-26-27-xx-xx-64-65-67-65-65-67-65-67-65-67-65-65-70-xx-xx-xx-xx-xx-xx-xx-xx-xx-xx-xx-xx-xx-xx-25-26-26-26-27-xx-xx-64-65-70-xx-xx-xx-xx-xx-xx-xx-xx-xx-25-26-26-26-26-26-26-26-26-26-26-26-26-27-xx-xx-xx-xx-xx-xx-xx-xx-xx-xx-xx-xx-xx-xx-xx-xx-xx-xx-xx-xx-33-34-43-xx-xx-xx-25-26-26-26-26-26-27-xx-xx-xx-xx-xx-xx-xx-xx-xx-xx-xx-xx-xx-xx-xx-xx-xx-xx-xx-xx-xx-xx-xx-xx-xx-xx-xx-xx-xx-xx-xx-xx-xx-xx-xx-xx-xx-41-34-42-42-42-43-xx-xx-25-26-26-26-26-26-27-xx-xx-xx-xx-xx-xx-xx-xx-xx-xx-xx-xx-xx-xx-xx-xx-xx-xx-xx-xx-xx-xx-xx-xx-xx-xx-xx-xx-xx-xx-xx
xx-xx-xx-xx-xx-xx-xx-xx-xx-xx-xx-xx-xx-xx-xx-64-65-70-xx-xx-xx-xx-xx-25-26-26-26-26-26-26-26-26-26-26-26-26-26-26-26-26-26-27-xx-xx-xx-xx-xx-xx-xx-xx-xx-xx-xx-xx-xx-xx-xx-xx-xx-xx-xx-xx-xx-xx-xx-xx-xx-xx-xx-xx-xx-25-26-26-26-27-xx-xx-xx-xx-xx-xx-xx-33-34-42-34-43-xx-xx-25-26-26-26-26-26-26-26-26-26-26-26-26-27-xx-xx-xx-xx-xx-xx-xx-xx-xx-xx-xx-xx-xx-xx-xx-xx-xx-xx-xx-xx-47-40-51-xx-xx-xx-25-26-26-26-26-26-27-xx-xx-xx-xx-xx-xx-xx-xx-xx-xx-xx-xx-xx-xx-xx-xx-xx-xx-xx-xx-xx-xx-xx-xx-xx-xx-xx-xx-xx-xx-xx-xx-xx-64-70-xx-xx-37-50-40-50-40-51-xx-xx-25-26-26-26-26-26-27-xx-xx-xx-xx-xx-xx-xx-xx-xx-xx-xx-xx-xx-xx-xx-xx-xx-xx-xx-xx-xx-xx-xx-xx-xx-xx-xx-xx-xx-xx-xx
xx-xx-xx-xx-xx-xx-xx-xx-xx-xx-xx-xx-xx-xx-xx-xx-xx-xx-xx-xx-xx-xx-xx-25-26-26-26-26-26-26-26-26-26-26-26-26-26-26-26-26-26-27-xx-xx-xx-xx-xx-xx-xx-xx-xx-xx-xx-xx-xx-xx-xx-xx-xx-xx-xx-xx-22-23-23-23-23-24-xx-xx-xx-25-26-26-26-27-xx-xx-xx-xx-xx-xx-xx-37-50-40-40-51-xx-xx-25-26-26-26-26-26-26-26-26-26-26-26-26-72-23-23-23-23-23-23-24-xx-xx-xx-xx-xx-xx-xx-xx-xx-xx-xx-xx-xx-xx-xx-xx-xx-xx-xx-25-26-26-26-26-26-27-xx-xx-xx-xx-xx-xx-xx-xx-xx-xx-xx-xx-xx-xx-xx-xx-xx-xx-xx-xx-xx-xx-xx-xx-66-65-70-xx-xx-64-65-70-xx-xx-xx-xx-xx-xx-xx-xx-xx-xx-xx-xx-xx-25-26-26-26-26-26-72-22-23-23-23-23-23-23-23-23-23-23-23-23-23-23-24-xx-xx-xx-xx-xx-xx-xx-xx-xx-xx-xx-xx-xx-xx-xx
xx-xx-xx-xx-22-23-23-23-23-23-23-23-23-24-xx-xx-xx-xx-xx-xx-xx-xx-xx-25-26-26-26-26-26-26-26-26-26-26-26-26-26-26-26-26-26-27-xx-xx-xx-xx-xx-xx-xx-xx-xx-xx-xx-xx-xx-xx-xx-xx-xx-xx-xx-xx-25-26-26-26-26-27-xx-xx-xx-25-26-26-26-27-xx-xx-xx-xx-xx-xx-xx-xx-xx-xx-xx-xx-xx-xx-25-26-26-26-26-26-26-26-26-26-26-26-26-26-26-26-26-26-26-26-27-xx-xx-xx-xx-xx-xx-xx-22-23-24-xx-xx-xx-xx-xx-xx-xx-xx-xx-25-26-26-26-26-26-27-xx-xx-xx-xx-xx-xx-xx-xx-xx-xx-xx-xx-xx-xx-xx-xx-xx-xx-xx-22-23-24-xx-xx-xx-xx-xx-xx-xx-xx-xx-xx-xx-xx-xx-xx-xx-xx-xx-xx-xx-xx-xx-xx-xx-25-26-26-26-26-26-26-26-26-26-26-26-26-26-26-26-26-26-26-26-26-26-27-xx-xx-xx-xx-xx-xx-xx-xx-xx-xx-xx-xx-xx-xx-xx
xx-xx-xx-xx-25-26-26-26-26-26-26-26-26-27-xx-xx-xx-xx-xx-xx-xx-xx-xx-25-26-26-26-26-26-26-26-26-26-26-26-26-26-26-26-26-26-27-xx-xx-xx-xx-xx-xx-xx-xx-xx-xx-xx-xx-xx-xx-xx-xx-22-23-23-23-72-26-26-26-26-27-xx-xx-xx-25-26-26-26-27-xx-xx-xx-xx-xx-xx-xx-xx-xx-xx-xx-xx-xx-22-71-26-26-26-26-26-26-26-26-26-26-26-26-26-26-26-26-26-26-26-27-xx-xx-xx-xx-xx-xx-xx-25-26-27-xx-xx-xx-xx-xx-xx-xx-xx-xx-25-26-26-26-26-26-27-xx-xx-xx-xx-xx-xx-xx-xx-xx-xx-xx-xx-xx-xx-xx-xx-xx-xx-xx-25-26-27-xx-xx-xx-xx-xx-xx-xx-xx-xx-xx-xx-xx-xx-xx-xx-xx-xx-xx-xx-xx-xx-xx-xx-25-26-26-26-26-26-26-26-26-26-26-26-26-26-26-26-26-26-26-26-26-26-27-xx-xx-xx-xx-xx-xx-xx-xx-xx-xx-xx-xx-xx-xx-xx
22-23-23-23-71-26-26-26-26-26-26-26-26-72-23-23-23-23-23-23-23-23-23-71-26-26-26-26-26-26-26-26-26-26-26-26-26-26-26-26-26-72-23-23-23-23-23-23-23-23-23-23-23-23-23-23-23-23-71-26-26-26-26-26-26-26-26-27-xx-xx-xx-25-26-26-26-72-23-23-23-23-23-23-23-23-23-23-23-23-23-71-26-26-26-26-26-26-26-26-26-26-26-26-26-26-26-26-26-26-26-26-72-23-23-23-23-23-23-23-71-26-72-23-23-23-23-23-23-23-23-23-71-26-26-26-26-26-72-23-23-23-23-23-23-23-23-23-23-23-23-23-23-23-23-23-23-23-71-26-72-23-23-23-23-23-23-23-23-23-23-23-23-23-23-23-23-23-23-23-23-23-23-23-71-26-26-26-26-26-26-26-26-26-26-26-26-26-26-26-26-26-26-26-26-26-72-23-23-23-23-23-23-23-23-23-23-23-23-23-23-23
25-26-26-26-26-26-26-26-26-26-26-26-26-26-26-26-26-26-26-26-26-26-26-26-26-26-26-26-26-26-26-26-26-26-26-26-26-26-26-26-26-26-26-26-26-26-26-26-26-26-26-26-26-26-26-26-26-26-26-26-26-26-26-26-26-26-26-27-xx-xx-xx-25-26-26-26-26-26-26-26-26-26-26-26-26-26-26-26-26-26-26-26-26-26-26-26-26-26-26-26-26-26-26-26-26-26-26-26-26-26-26-26-26-26-26-26-26-26-26-26-26-26-26-26-26-26-26-26-26-26-26-26-26-26-26-26-26-26-26-26-26-26-26-26-26-26-26-26-26-26-26-26-26-26-26-26-26-26-26-26-26-26-26-26-26-26-26-26-26-26-26-26-26-26-26-26-26-26-26-26-26-26-26-26-26-26-26-26-26-26-26-26-26-26-26-26-26-26-26-26-26-26-26-26-26-26-26-26-26-26-26-26-26-26-26-26-26-26-26-26-26
25-26-26-26-26-26-26-26-26-26-26-26-26-26-26-26-26-26-26-26-26-26-26-26-26-26-26-26-26-26-26-26-26-26-26-26-26-26-26-26-26-26-26-26-26-26-26-26-26-26-26-26-26-26-26-26-26-26-26-26-26-26-26-26-26-26-26-27-xx-xx-xx-25-26-26-26-26-26-26-26-26-26-26-26-26-26-26-26-26-26-26-26-26-26-26-26-26-26-26-26-26-26-26-26-26-26-26-26-26-26-26-26-26-26-26-26-26-26-26-26-26-26-26-26-26-26-26-26-26-26-26-26-26-26-26-26-26-26-26-26-26-26-26-26-26-26-26-26-26-26-26-26-26-26-26-26-26-26-26-26-26-26-26-26-26-26-26-26-26-26-26-26-26-26-26-26-26-26-26-26-26-26-26-26-26-26-26-26-26-26-26-26-26-26-26-26-26-26-26-26-26-26-26-26-26-26-26-26-26-26-26-26-26-26-26-26-26-26-26-26-26
25-26-26-26-26-26-26-26-26-26-26-26-26-26-26-26-26-26-26-26-26-26-26-26-26-26-26-26-26-26-26-26-26-26-26-26-26-26-26-26-26-26-26-26-26-26-26-26-26-26-26-26-26-26-26-26-26-26-26-26-26-26-26-26-26-26-26-27-xx-xx-xx-25-26-26-26-26-26-26-26-26-26-26-26-26-26-26-26-26-26-26-26-26-26-26-26-26-26-26-26-26-26-26-26-26-26-26-26-26-26-26-26-26-26-26-26-26-26-26-26-26-26-26-26-26-26-26-26-26-26-26-26-26-26-26-26-26-26-26-26-26-26-26-26-26-26-26-26-26-26-26-26-26-26-26-26-26-26-26-26-26-26-26-26-26-26-26-26-26-26-26-26-26-26-26-26-26-26-26-26-26-26-26-26-26-26-26-26-26-26-26-26-26-26-26-26-26-26-26-26-26-26-26-26-26-26-26-26-26-26-26-26-26-26-26-26-26-26-26-26-26