xx-xx-xx-xx-xx-xx-xx-xx-xx-xx-xx-xx-xx-xx-xx-xx-xx-xx-xx-xx-xx-xx-xx-xx-xx-xx-xx-xx-xx-xx-xx-xx-xx-xx-xx-xx-xx
xx-xx-xx-xx-xx-xx-xx-xx-xx-xx-xx-xx-xx-xx-xx-xx-xx-xx-xx-xx-xx-xx-xx-xx-xx-xx-xx-xx-xx-xx-xx-xx-xx-xx-xx-xx-xx
xx-xx-xx-xx-xx-xx-xx-xx-xx-xx-xx-xx-xx-xx-xx-xx-xx-xx-xx-xx-xx-xx-xx-xx-xx-xx-xx-xx-xx-xx-xx-xx-xx-xx-xx-xx-xx
xx-xx-xx-xx-xx-xx-xx-xx-xx-xx-xx-xx-xx-xx-xx-xx-xx-xx-xx-xx-xx-xx-xx-xx-xx-xx-xx-xx-xx-xx-xx-xx-xx-xx-xx-xx-xx
xx-xx-xx-xx-xx-xx-xx-xx-xx-xx-xx-xx-xx-xx-xx-xx-xx-xx-xx-xx-xx-xx-xx-xx-xx-xx-xx-xx-xx-xx-xx-xx-xx-xx-xx-xx-xx
xx-xx-xx-xx-xx-xx-xx-xx-xx-xx-xx-xx-xx-xx-xx-xx-xx-xx-xx-xx-xx-xx-xx-xx-xx-xx-xx-xx-xx-xx-xx-xx-xx-xx-xx-xx-xx
xx-xx-xx-xx-xx-xx-xx-xx-xx-xx-xx-xx-xx-xx-xx-xx-xx-xx-xx-xx-xx-xx-xx-xx-xx-xx-xx-xx-xx-xx-xx-xx-xx-xx-xx-xx-xx
xx-xx-xx-00-01-01-02-xx-xx-xx-xx-xx-xx-00-01-01-01-02-xx-xx-xx-xx-xx-xx-xx-xx-xx-xx-xx-xx-xx-xx-xx-xx-xx-xx-xx
xx-xx-xx-03-04-04-05-xx-xx-xx-xx-xx-xx-03-04-04-04-05-xx-xx-xx-xx-xx-xx-xx-xx-xx-xx-xx-xx-xx-xx-xx-xx-xx-xx-xx
00-01-01-04-04-04-04-01-01-01-01-01-01-04-04-04-04-04-01-01-01-01-01-01-02-xx-xx-xx-xx-xx-xx-xx-xx-xx-xx-xx-xx
03-04-04-04-04-04-04-04-04-04-04-04-04-04-04-04-04-04-04-04-04-04-04-04-05-xx-xx-xx-xx-xx-xx-xx-xx-xx-xx-xx-xx
03-04-04-04-04-04-04-04-04-04-04-04-04-04-04-04-04-04-04-04-04-04-04-04-05-xx-xx-xx-xx-xx-xx-xx-xx-xx-xx-xx-xx
03-04-04-04-04-04-04-04-04-04-04-04-04-04-04-04-04-04-04-04-04-04-04-04-05-xx-xx-xx-xx-xx-xx-xx-xx-xx-xx-xx-xx