xx-xx-xx-xx-xx-xx-xx-xx-xx-xx-xx-xx-xx-xx-xx-xx-xx-xx-xx-xx-xx-xx-xx-xx-xx-xx-xx-xx-xx-xx-xx-xx-xx-xx-xx-xx-xx-xx-xx-xx-xx-xx-xx-xx-xx-xx-xx-xx-xx-xx-xx-xx-xx-xx-xx-xx-xx-xx-xx-xx-xx-xx-xx-xx-xx-xx-xx-xx-xx-xx-xx-xx-xx-xx-xx-xx-xx-xx-xx-xx-xx-xx-xx-xx-xx-xx-xx-xx-xx-xx-xx-xx-xx-xx-xx-xx-xx-xx-xx-xx-xx-xx-xx-xx-xx-xx-xx-xx-xx-xx-xx-xx-xx-xx-xx-xx-xx-xx-xx-xx-xx-xx-xx-xx-xx-xx-xx-xx-xx-xx-xx-xx-xx-xx-xx-xx-xx-xx-xx-xx-xx-xx-xx-xx-xx-xx-xx-xx-xx-xx-xx-xx-xx-xx-xx-xx-xx-xx-xx-xx-xx-xx-xx-xx-xx-xx-xx-xx-xx-xx-xx-xx-xx-xx-xx-xx-xx-xx-xx-xx-xx-xx-xx-xx-xx-xx-xx-xx-xx-xx-xx-xx
xx-xx-xx-xx-xx-xx-xx-xx-xx-xx-xx-xx-xx-xx-xx-xx-xx-xx-xx-xx-xx-xx-xx-xx-xx-xx-xx-xx-xx-xx-xx-xx-xx-xx-xx-xx-xx-xx-xx-xx-xx-xx-xx-xx-xx-xx-xx-xx-xx-xx-xx-xx-xx-xx-xx-xx-xx-xx-xx-xx-xx-xx-xx-xx-xx-xx-xx-xx-xx-xx-xx-xx-xx-xx-xx-xx-xx-xx-xx-xx-xx-xx-xx-xx-xx-xx-xx-xx-xx-xx-xx-xx-xx-xx-xx-xx-xx-xx-xx-xx-xx-xx-xx-xx-xx-xx-xx-xx-xx-xx-xx-xx-xx-xx-xx-xx-xx-xx-xx-xx-xx-xx-xx-xx-xx-xx-xx-xx-xx-xx-xx-xx-xx-xx-xx-xx-xx-xx-xx-xx-xx-xx-xx-xx-xx-xx-xx-xx-xx-xx-xx-xx-xx-xx-xx-xx-xx-xx-xx-xx-xx-xx-xx-xx-xx-xx-xx-xx-xx-xx-xx-xx-xx-xx-xx-xx-xx-xx-xx-xx-xx-xx-xx-xx-xx-xx-xx-xx-xx-xx-xx-xx
xx-xx-xx-xx-xx-xx-xx-xx-xx-xx-xx-xx-xx-xx-xx-xx-xx-xx-xx-xx-xx-xx-xx-xx-xx-xx-xx-xx-xx-xx-xx-xx-xx-xx-xx-xx-xx-xx-xx-xx-xx-xx-xx-xx-xx-xx-xx-xx-xx-xx-xx-xx-xx-xx-xx-xx-xx-xx-xx-xx-xx-xx-xx-xx-xx-xx-xx-xx-xx-xx-xx-xx-xx-xx-xx-xx-xx-xx-xx-xx-xx-xx-xx-xx-xx-xx-xx-xx-xx-xx-xx-xx-xx-xx-xx-xx-xx-xx-xx-xx-xx-xx-xx-xx-xx-xx-xx-xx-xx-xx-xx-xx-xx-xx-xx-xx-xx-xx-xx-xx-xx-xx-xx-xx-xx-xx-xx-xx-xx-xx-xx-xx-xx-xx-xx-xx-xx-xx-xx-xx-xx-xx-xx-xx-xx-xx-xx-xx-xx-xx-xx-xx-xx-xx-xx-xx-xx-xx-xx-xx-xx-xx-xx-xx-xx-xx-xx-xx-xx-xx-xx-xx-xx-xx-xx-xx-xx-xx-xx-xx-xx-xx-xx-xx-xx-xx-xx-xx-xx-xx-xx-xx
xx-xx-xx-xx-xx-xx-xx-xx-xx-xx-xx-xx-xx-xx-xx-xx-xx-xx-xx-xx-xx-xx-12-14-xx-xx-xx-xx-xx-xx-xx-xx-xx-xx-xx-xx-xx-xx-xx-xx-xx-xx-xx-xx-xx-xx-xx-xx-xx-xx-xx-xx-xx-xx-xx-xx-xx-xx-xx-xx-xx-xx-xx-xx-xx-xx-xx-xx-xx-xx-xx-xx-xx-xx-xx-xx-xx-xx-xx-12-13-13-13-13-13-13-13-13-14-xx-xx-xx-xx-xx-xx-xx-xx-xx-xx-xx-xx-xx-xx-xx-xx-xx-xx-xx-xx-xx-xx-xx-xx-xx-xx-xx-xx-xx-xx-xx-xx-xx-xx-xx-xx-xx-xx-xx-xx-xx-xx-xx-xx-xx-xx-xx-xx-xx-xx-xx-xx-xx-xx-xx-xx-xx-xx-xx-xx-xx-xx-xx-xx-xx-xx-xx-xx-xx-xx-xx-xx-xx-xx-xx-xx-xx-xx-xx-xx-xx-xx-xx-xx-xx-xx-xx-xx-xx-xx-xx-xx-xx-xx-xx-xx-xx-xx-xx-xx-xx-xx-xx
xx-xx-xx-xx-xx-xx-xx-xx-xx-xx-xx-xx-xx-xx-12-13-14-xx-xx-12-13-14-16-20-xx-xx-12-13-13-13-13-13-13-14-xx-xx-xx-xx-xx-xx-xx-xx-xx-xx-xx-xx-12-13-13-13-13-13-13-14-xx-xx-xx-xx-xx-xx-xx-xx-xx-xx-12-13-13-13-13-13-13-13-13-13-13-14-xx-xx-xx-15-16-16-16-16-16-16-16-16-20-xx-xx-xx-12-13-13-13-13-14-xx-xx-xx-xx-xx-xx-xx-xx-xx-xx-xx-xx-xx-xx-xx-xx-xx-xx-xx-xx-xx-xx-xx-xx-xx-xx-xx-12-13-13-13-13-14-xx-xx-xx-xx-xx-xx-xx-xx-xx-12-13-13-13-13-13-13-13-13-13-13-13-13-13-14-xx-xx-xx-xx-xx-xx-xx-xx-xx-xx-xx-xx-xx-xx-xx-xx-xx-xx-xx-xx-xx-xx-xx-xx-xx-xx-15-13-13-13-13-13-13-13-13-13-13
xx-xx-xx-xx-xx-xx-xx-xx-xx-xx-12-14-xx-xx-xx-xx-xx-xx-xx-xx-xx-xx-xx-xx-xx-xx-15-16-16-16-16-16-16-20-xx-xx-xx-xx-xx-xx-xx-xx-xx-xx-xx-xx-xx-xx-xx-xx-xx-xx-xx-xx-xx-xx-12-13-13-13-13-14-xx-xx-xx-xx-xx-xx-xx-xx-xx-xx-xx-xx-xx-xx-xx-xx-xx-15-16-16-16-16-16-16-16-16-20-xx-xx-xx-xx-xx-xx-xx-xx-xx-xx-xx-xx-xx-xx-xx-xx-xx-xx-xx-xx-xx-xx-xx-xx-xx-xx-xx-xx-xx-xx-xx-xx-xx-xx-xx-xx-21-22-22-22-22-23-xx-xx-12-13-13-13-14-xx-xx-xx-xx-xx-xx-xx-xx-xx-xx-xx-xx-xx-xx-xx-xx-xx-xx-xx-12-13-13-13-14-xx-xx-xx-xx-xx-xx-xx-xx-xx-xx-xx-12-13-13-13-13-13-13-13-16-16-16-16-16-16-16-16-16-16-16
xx-xx-xx-xx-xx-xx-xx-xx-xx-xx-15-20-xx-xx-xx-xx-xx-xx-xx-xx-xx-xx-xx-xx-xx-xx-15-16-16-16-16-16-16-16-13-13-13-13-13-13-13-13-13-14-xx-xx-xx-xx-xx-xx-xx-xx-xx-xx-xx-xx-xx-xx-xx-xx-xx-xx-xx-xx-xx-xx-xx-xx-xx-xx-xx-xx-xx-xx-xx-xx-xx-xx-xx-15-16-16-16-16-16-16-16-16-20-xx-xx-xx-xx-xx-xx-xx-xx-xx-xx-xx-xx-xx-xx-xx-xx-xx-xx-xx-xx-xx-xx-xx-xx-12-13-13-13-13-13-13-13-13-14-xx-xx-xx-xx-xx-xx-xx-xx-xx-xx-xx-xx-xx-xx-xx-xx-xx-xx-xx-xx-xx-xx-xx-xx-xx-xx-xx-xx-xx-xx-xx-xx-xx-xx-21-22-22-22-23-xx-xx-xx-xx-xx-xx-xx-xx-xx-xx-xx-15-16-16-16-16-16-16-16-16-16-16-16-16-16-16-16-16-16-16
xx-xx-xx-xx-xx-xx-xx-12-13-13-16-20-xx-xx-xx-xx-xx-xx-xx-xx-xx-xx-xx-xx-xx-xx-15-16-16-16-16-16-16-16-16-16-16-16-16-16-16-16-16-20-xx-xx-xx-xx-xx-xx-xx-xx-xx-xx-xx-xx-xx-xx-xx-xx-xx-xx-xx-xx-12-13-14-xx-xx-xx-xx-xx-xx-xx-xx-xx-xx-12-13-15-16-16-16-16-16-16-16-16-20-xx-xx-xx-xx-xx-xx-xx-xx-xx-xx-xx-xx-xx-xx-xx-xx-xx-xx-xx-xx-xx-12-13-13-16-16-16-16-16-16-16-16-16-20-xx-xx-xx-xx-xx-xx-xx-xx-xx-xx-xx-xx-xx-xx-xx-xx-xx-xx-xx-xx-xx-xx-xx-xx-xx-xx-xx-xx-xx-xx-xx-xx-xx-xx-xx-xx-xx-xx-xx-xx-xx-xx-xx-xx-xx-xx-xx-12-13-13-16-16-16-16-16-16-16-16-16-16-16-16-16-16-16-16-16-16-16
xx-xx-xx-xx-xx-xx-xx-15-16-16-16-20-xx-xx-xx-xx-xx-xx-xx-xx-xx-xx-xx-xx-xx-xx-15-16-16-16-16-16-16-16-16-16-16-16-16-16-16-16-16-16-13-13-13-13-13-13-13-13-xx-xx-xx-xx-xx-xx-xx-xx-xx-xx-xx-xx-15-16-20-xx-xx-xx-xx-xx-xx-xx-xx-xx-xx-15-16-16-16-16-16-16-16-16-16-16-20-xx-xx-xx-xx-xx-xx-xx-xx-xx-xx-xx-xx-xx-xx-xx-xx-xx-xx-xx-xx-xx-15-16-16-16-16-16-16-16-16-16-16-16-20-xx-xx-xx-xx-xx-xx-xx-xx-xx-xx-xx-xx-xx-xx-xx-xx-xx-xx-xx-xx-xx-xx-xx-xx-xx-xx-xx-xx-xx-xx-xx-xx-xx-xx-xx-xx-xx-xx-xx-xx-xx-xx-xx-xx-xx-xx-xx-15-16-16-16-16-16-16-16-16-16-16-16-16-16-16-16-16-16-16-16-16-16
12-13-13-13-13-13-13-16-16-16-16-16-13-13-13-13-13-13-13-13-13-13-13-13-13-13-16-16-16-16-16-16-16-16-16-16-16-16-16-16-16-16-16-16-16-16-16-16-16-16-16-16-13-13-13-13-13-13-13-13-13-13-13-13-16-16-16-13-13-13-13-13-13-13-13-13-13-16-16-16-16-16-16-16-16-16-16-16-20-xx-xx-xx-13-13-13-13-13-13-13-13-13-13-13-13-13-13-13-13-13-13-13-13-13-16-16-16-16-16-16-16-16-16-16-13-13-13-13-13-13-13-13-13-13-13-13-13-13-13-13-13-13-13-13-13-13-13-13-13-13-13-13-13-13-13-13-13-13-13-13-13-13-13-13-13-13-13-13-13-13-13-16-16-16-16-16-16-16-16-16-16-16-16-16-16-16-16-16-16-16-16-16-16
15-16-16-16-16-16-16-16-16-16-16-16-16-16-16-16-16-16-16-16-16-16-16-16-16-16-16-16-16-16-16-16-16-16-16-16-16-16-16-16-16-16-16-16-16-16-16-16-16-16-16-16-16-16-16-16-16-16-16-16-16-16-16-16-16-16-16-16-16-16-16-16-16-16-16-16-16-16-16-16-16-16-16-16-16-16-16-16-20-xx-xx-xx-16-16-16-16-16-16-16-16-16-16-16-16-16-16-16-16-16-16-16-16-16-16-16-16-16-16-16-16-16-16-16-16-16-16-16-16-16-16-16-16-16-16-16-16-16-16-16-16-16-16-16-16-16-16-16-16-16-16-16-16-16-16-16-16-16-16-16-16-16-16-16-16-16-16-16-16-16-16-16-16-16-16-16-16-16-16-16-16-16-16-16-16-16-16-16-16-16-16-16-16
15-16-16-16-16-16-16-16-16-16-16-16-16-16-16-16-16-16-16-16-16-16-16-16-16-16-16-16-16-16-16-16-16-16-16-16-16-16-16-16-16-16-16-16-16-16-16-16-16-16-16-16-16-16-16-16-16-16-16-16-16-16-16-16-16-16-16-16-16-16-16-16-16-16-16-16-16-16-16-16-16-16-16-16-16-16-16-16-20-xx-xx-xx-16-16-16-16-16-16-16-16-16-16-16-16-16-16-16-16-16-16-16-16-16-16-16-16-16-16-16-16-16-16-16-16-16-16-16-16-16-16-16-16-16-16-16-16-16-16-16-16-16-16-16-16-16-16-16-16-16-16-16-16-16-16-16-16-16-16-16-16-16-16-16-16-16-16-16-16-16-16-16-16-16-16-16-16-16-16-16-16-16-16-16-16-16-16-16-16-16-16-16-16
15-16-16-16-16-16-16-16-16-16-16-16-16-16-16-16-16-16-16-16-16-16-16-16-16-16-16-16-16-16-16-16-16-16-16-16-16-16-16-16-16-16-16-16-16-16-16-16-16-16-16-16-16-16-16-16-16-16-16-16-16-16-16-16-16-16-16-16-16-16-16-16-16-16-16-16-16-16-16-16-16-16-16-16-16-16-16-16-20-xx-xx-xx-16-16-16-16-16-16-16-16-16-16-16-16-16-16-16-16-16-16-16-16-16-16-16-16-16-16-16-16-16-16-16-16-16-16-16-16-16-16-16-16-16-16-16-16-16-16-16-16-16-16-16-16-16-16-16-16-16-16-16-16-16-16-16-16-16-16-16-16-16-16-16-16-16-16-16-16-16-16-16-16-16-16-16-16-16-16-16-16-16-16-16-16-16-16-16-16-16-16-16-16
                                                                                                                                                                                                                                                                           