xx-xx-xx-xx-xx-xx-xx-xx-xx-xx-xx-xx-xx-xx-xx-xx-xx-xx-xx-xx-xx-xx-xx-xx-xx-xx-xx-xx-xx-xx-xx-xx-xx-xx-xx-xx-xx-xx-xx-xx-xx-xx-xx-xx-xx-xx-xx-xx-xx-xx-xx-xx-xx-xx-xx-xx-xx-xx-xx-xx-xx-xx-xx-xx-xx-xx
xx-xx-xx-xx-xx-xx-xx-xx-xx-xx-xx-xx-xx-xx-xx-xx-xx-xx-xx-xx-xx-xx-xx-xx-xx-xx-xx-xx-xx-xx-xx-xx-xx-xx-xx-xx-xx-xx-xx-xx-xx-xx-00-01-01-01-01-02-xx-xx-xx-xx-xx-xx-xx-xx-xx-xx-xx-xx-xx-xx-xx-xx-xx-xx
xx-xx-xx-xx-xx-xx-xx-xx-xx-xx-xx-xx-xx-xx-xx-xx-xx-xx-xx-xx-xx-xx-xx-xx-xx-xx-xx-xx-xx-xx-xx-xx-xx-xx-xx-xx-xx-xx-xx-xx-xx-xx-03-04-04-04-04-05-xx-xx-xx-xx-xx-xx-xx-xx-xx-xx-xx-xx-xx-xx-xx-xx-xx-xx
xx-xx-xx-xx-xx-xx-xx-xx-xx-xx-xx-xx-xx-xx-xx-xx-xx-xx-xx-xx-xx-xx-xx-xx-xx-xx-xx-xx-xx-xx-xx-xx-xx-xx-xx-xx-xx-00-01-02-xx-xx-03-04-04-04-04-05-xx-xx-xx-xx-xx-xx-xx-xx-xx-xx-xx-xx-xx-xx-xx-xx-xx-xx
xx-xx-xx-xx-xx-xx-xx-xx-xx-xx-xx-xx-xx-xx-xx-xx-xx-xx-xx-xx-xx-xx-xx-xx-xx-xx-xx-xx-xx-xx-xx-xx-xx-xx-xx-xx-xx-06-07-10-xx-xx-03-04-04-04-04-05-xx-xx-xx-xx-xx-xx-xx-xx-xx-xx-xx-xx-xx-xx-xx-xx-xx-xx
xx-xx-xx-xx-xx-xx-xx-xx-xx-xx-xx-xx-xx-xx-xx-xx-xx-xx-xx-xx-xx-xx-xx-xx-xx-xx-xx-xx-xx-xx-xx-xx-xx-xx-xx-xx-xx-xx-xx-xx-xx-xx-03-04-04-04-04-05-xx-xx-xx-xx-xx-xx-xx-xx-xx-xx-xx-xx-xx-xx-xx-xx-xx-xx
xx-xx-xx-xx-xx-xx-xx-xx-xx-xx-xx-xx-xx-xx-xx-xx-xx-xx-xx-xx-xx-xx-xx-xx-xx-xx-xx-xx-xx-xx-xx-xx-xx-xx-xx-xx-xx-xx-xx-xx-xx-xx-03-04-04-04-04-05-xx-xx-xx-xx-xx-xx-xx-xx-xx-xx-xx-xx-xx-xx-xx-xx-xx-xx
xx-xx-xx-00-01-01-02-xx-xx-xx-xx-xx-xx-00-01-01-01-02-xx-xx-xx-xx-xx-xx-xx-xx-xx-xx-xx-xx-xx-xx-xx-xx-xx-xx-xx-00-01-01-01-01-55-04-04-04-04-05-xx-xx-xx-xx-xx-xx-xx-xx-xx-xx-xx-xx-xx-xx-xx-xx-xx-xx
xx-xx-xx-03-04-04-05-xx-xx-xx-xx-xx-xx-03-04-04-04-05-xx-xx-xx-xx-xx-xx-xx-xx-xx-xx-xx-xx-xx-xx-xx-xx-xx-xx-xx-03-04-04-04-04-04-04-04-04-04-05-xx-xx-xx-xx-xx-xx-xx-xx-xx-xx-xx-xx-xx-xx-xx-xx-xx-xx
00-01-01-55-04-04-15-15-15-15-01-01-01-55-04-04-04-56-01-01-01-01-01-01-02-xx-xx-xx-xx-xx-xx-xx-xx-xx-00-01-01-55-04-04-04-04-04-04-04-04-04-05-xx-xx-xx-xx-xx-xx-xx-xx-xx-xx-xx-xx-xx-xx-xx-xx-xx-xx
03-04-04-04-04-04-04-04-04-04-04-04-04-04-04-04-04-04-04-04-04-04-04-04-05-xx-xx-xx-xx-xx-xx-xx-xx-xx-03-04-04-04-04-04-04-04-04-04-04-04-04-56-01-01-01-01-01-01-01-01-01-01-01-01-01-01-01-01-01-01
03-04-04-04-04-04-04-04-04-04-04-04-04-04-04-04-04-04-04-04-04-04-04-04-05-xx-xx-xx-xx-xx-xx-xx-xx-xx-03-04-04-04-04-04-04-04-04-04-04-04-04-04-04-04-04-04-04-04-04-04-04-04-04-04-04-04-04-04-04-04
03-04-04-04-04-04-04-04-04-04-04-04-04-04-04-04-04-04-04-04-04-04-04-04-05-xx-xx-xx-xx-xx-xx-xx-xx-xx-03-04-04-04-04-04-04-04-04-04-04-04-04-04-04-04-04-04-04-04-04-04-04-04-04-04-04-04-04-04-04-04