xx-xx-xx-xx-xx-xx-xx-xx-xx-xx-xx-xx-xx-xx-xx-xx-xx-xx-xx-xx-xx-xx-xx-xx-xx-xx-xx-xx-xx-xx-xx-xx-xx-xx-xx-xx-xx-xx-xx-xx-xx-xx-xx-xx-xx-xx-xx-xx-xx-xx-xx-xx-xx-xx-xx-xx-xx-xx-xx-xx-xx-xx-xx-xx-xx-xx-xx-xx-xx-xx-xx-xx-xx-xx-xx-xx-xx-xx-xx-xx-xx-xx-xx-xx-xx-xx-xx-xx-xx-xx-xx-xx-xx-xx-xx-xx-xx-xx-xx-xx-xx-xx-xx-xx-xx-xx-xx-xx-xx-xx-xx-xx-xx-xx-xx-xx-xx-xx-xx-xx-xx-xx-xx-xx-xx-xx-xx-xx-xx-xx-xx-xx-xx-xx-xx-xx-xx-xx-xx-xx-xx-xx-xx-xx-xx-xx-xx-xx-xx-xx-xx-xx-xx-xx-xx-xx-xx-xx-xx-xx-xx-xx-xx-xx-xx-xx-xx-xx-xx-xx-xx-xx-xx-xx-xx-xx-xx-xx-xx-xx-xx-xx-xx-xx-xx-xx-xx-xx-xx-xx-xx-xx-xx-xx-xx-xx-xx-xx-xx-xx-xx-xx-xx-xx-xx-xx-xx-xx-xx-xx-xx-xx-xx-xx-xx-xx-xx-xx-xx-xx-xx-xx-xx-xx-xx-xx-xx-xx-xx-xx-xx-xx-xx
xx-xx-xx-xx-xx-xx-xx-xx-xx-xx-xx-xx-xx-xx-xx-xx-xx-xx-xx-xx-xx-xx-xx-xx-xx-xx-xx-xx-xx-xx-xx-xx-xx-xx-xx-xx-xx-xx-xx-xx-xx-xx-xx-xx-xx-xx-xx-xx-xx-xx-xx-xx-xx-xx-xx-xx-xx-xx-xx-xx-xx-xx-xx-xx-xx-xx-xx-xx-xx-xx-xx-xx-xx-xx-xx-xx-xx-xx-xx-xx-xx-xx-xx-xx-xx-xx-xx-xx-xx-xx-xx-xx-xx-xx-xx-xx-xx-xx-xx-xx-xx-xx-xx-xx-xx-xx-xx-xx-xx-xx-xx-xx-xx-xx-xx-xx-xx-xx-xx-xx-xx-xx-xx-xx-xx-xx-xx-xx-xx-xx-xx-xx-xx-xx-xx-xx-xx-xx-xx-xx-xx-xx-xx-xx-xx-xx-xx-xx-xx-xx-xx-xx-xx-xx-xx-xx-xx-xx-xx-xx-xx-xx-xx-xx-xx-xx-xx-xx-xx-xx-xx-xx-xx-xx-xx-xx-xx-xx-xx-xx-xx-xx-xx-xx-xx-xx-xx-xx-xx-xx-xx-xx-xx-xx-xx-xx-xx-xx-xx-xx-xx-xx-xx-xx-xx-xx-xx-xx-xx-xx-xx-xx-xx-xx-xx-xx-xx-xx-xx-xx-xx-xx-xx-xx-xx-xx-xx-xx-xx-xx-xx-xx-xx
xx-xx-xx-xx-xx-xx-xx-xx-xx-xx-xx-xx-xx-xx-xx-xx-xx-xx-xx-xx-xx-xx-xx-xx-xx-xx-xx-xx-xx-xx-xx-xx-xx-xx-xx-xx-xx-xx-xx-xx-xx-xx-xx-xx-xx-xx-xx-xx-xx-xx-xx-xx-xx-xx-xx-xx-xx-xx-xx-xx-xx-xx-xx-xx-xx-xx-xx-xx-xx-xx-xx-xx-xx-xx-xx-xx-xx-xx-xx-xx-xx-xx-xx-xx-xx-xx-xx-xx-xx-xx-xx-xx-xx-xx-xx-xx-xx-xx-xx-xx-xx-xx-xx-xx-xx-xx-xx-xx-xx-xx-xx-xx-xx-xx-xx-xx-xx-xx-xx-xx-xx-xx-xx-xx-xx-xx-xx-xx-xx-xx-xx-xx-xx-xx-xx-xx-xx-xx-xx-xx-xx-xx-xx-xx-xx-xx-xx-xx-xx-xx-xx-xx-xx-xx-xx-xx-xx-xx-xx-xx-xx-xx-xx-xx-xx-xx-xx-xx-xx-xx-xx-xx-xx-xx-xx-xx-xx-xx-xx-xx-xx-xx-xx-xx-xx-xx-xx-xx-xx-xx-xx-xx-xx-xx-xx-xx-xx-xx-xx-xx-xx-xx-xx-xx-xx-xx-xx-xx-xx-xx-xx-xx-xx-xx-xx-xx-xx-xx-xx-xx-xx-xx-xx-xx-xx-xx-xx-xx-xx-xx-xx-xx-xx
xx-xx-xx-xx-xx-xx-xx-xx-xx-xx-xx-xx-xx-xx-xx-xx-xx-xx-xx-xx-xx-xx-xx-xx-xx-xx-xx-xx-xx-xx-xx-xx-xx-xx-xx-xx-xx-xx-xx-xx-xx-xx-xx-xx-xx-xx-xx-xx-xx-xx-xx-xx-xx-xx-xx-xx-xx-xx-xx-xx-xx-xx-xx-xx-xx-xx-xx-xx-xx-xx-xx-xx-xx-xx-xx-xx-xx-xx-xx-xx-xx-xx-xx-xx-xx-xx-xx-xx-xx-xx-xx-xx-xx-xx-xx-xx-xx-xx-xx-xx-xx-xx-xx-xx-xx-xx-xx-xx-xx-xx-xx-xx-xx-xx-xx-xx-xx-xx-xx-xx-xx-xx-xx-xx-xx-xx-xx-xx-xx-xx-xx-xx-xx-xx-xx-xx-xx-xx-xx-xx-xx-xx-xx-xx-xx-xx-xx-xx-xx-xx-xx-xx-xx-xx-xx-xx-xx-xx-xx-xx-xx-xx-xx-xx-xx-xx-xx-xx-xx-xx-xx-xx-xx-xx-xx-xx-xx-xx-xx-xx-xx-xx-xx-xx-xx-xx-xx-xx-xx-xx-xx-xx-xx-xx-xx-xx-xx-xx-xx-xx-xx-xx-xx-xx-xx-xx-xx-xx-xx-xx-xx-xx-xx-xx-xx-xx-xx-xx-xx-xx-xx-xx-xx-xx-xx-xx-xx-xx-xx-xx-xx-xx-xx
xx-xx-xx-xx-xx-xx-xx-xx-xx-xx-xx-xx-xx-xx-xx-xx-xx-xx-xx-xx-xx-xx-xx-xx-xx-xx-xx-xx-xx-xx-xx-xx-xx-xx-xx-xx-xx-xx-xx-xx-xx-xx-xx-xx-xx-xx-xx-xx-xx-xx-xx-xx-xx-xx-xx-xx-xx-xx-xx-xx-xx-xx-xx-xx-xx-xx-xx-xx-xx-xx-xx-xx-xx-xx-xx-xx-xx-xx-xx-xx-xx-xx-xx-xx-xx-xx-xx-xx-xx-xx-xx-xx-xx-xx-xx-xx-xx-xx-xx-xx-xx-xx-xx-xx-xx-xx-xx-xx-xx-xx-xx-xx-xx-xx-xx-xx-xx-xx-xx-xx-xx-xx-xx-xx-xx-xx-xx-xx-xx-xx-xx-xx-xx-xx-xx-xx-xx-xx-xx-xx-xx-xx-xx-xx-xx-xx-xx-xx-xx-xx-xx-xx-xx-xx-xx-xx-xx-xx-xx-xx-xx-xx-xx-xx-xx-xx-xx-xx-xx-xx-xx-xx-xx-xx-xx-xx-xx-xx-xx-xx-xx-xx-xx-xx-xx-xx-xx-xx-xx-xx-xx-xx-xx-xx-xx-xx-xx-xx-xx-xx-xx-xx-xx-xx-xx-xx-xx-xx-xx-xx-xx-xx-xx-xx-xx-xx-xx-xx-xx-xx-xx-xx-xx-xx-xx-xx-xx-xx-xx-xx-xx-xx-xx
xx-xx-xx-xx-xx-xx-xx-xx-xx-xx-xx-xx-xx-xx-xx-xx-xx-xx-xx-xx-xx-xx-xx-xx-xx-xx-xx-xx-xx-xx-xx-xx-xx-xx-xx-xx-xx-xx-xx-xx-xx-xx-xx-xx-xx-xx-xx-xx-xx-xx-xx-xx-xx-xx-xx-xx-xx-xx-11-12-12-12-12-12-13-xx-xx-xx-xx-xx-xx-xx-xx-xx-xx-xx-xx-11-12-13-xx-xx-xx-xx-xx-xx-xx-xx-xx-xx-xx-xx-xx-xx-xx-xx-xx-xx-xx-xx-xx-xx-xx-xx-xx-11-12-12-12-12-13-xx-xx-xx-xx-xx-xx-xx-xx-xx-11-12-12-13-xx-xx-57-60-xx-xx-xx-xx-xx-xx-xx-xx-xx-xx-xx-xx-xx-11-12-12-12-12-12-12-13-xx-xx-xx-xx-xx-xx-xx-xx-xx-xx-xx-xx-xx-xx-xx-xx-xx-xx-xx-xx-xx-xx-xx-xx-xx-xx-xx-xx-xx-xx-xx-xx-xx-xx-57-61-61-61-61-61-61-61-61-61-61-61-61-61-61-61-61-61-61-61-61-61-60-xx-xx-57-61-61-61-61-61-61-61-60-xx-xx-xx-xx-xx-xx-xx-xx-xx-xx-xx-xx-xx-xx-xx-xx
xx-xx-xx-xx-xx-xx-xx-xx-xx-xx-xx-xx-xx-11-12-12-12-12-12-12-12-12-12-12-12-12-12-12-12-12-12-12-12-12-12-12-12-12-12-12-12-12-13-xx-xx-xx-xx-xx-xx-xx-xx-xx-xx-57-61-60-xx-xx-14-15-15-15-15-15-16-xx-xx-xx-xx-xx-xx-xx-xx-xx-xx-xx-xx-14-15-16-xx-xx-xx-xx-xx-xx-xx-xx-xx-xx-xx-xx-xx-xx-xx-xx-xx-xx-xx-xx-57-61-60-xx-xx-17-20-20-20-20-21-xx-xx-57-61-60-xx-xx-xx-xx-14-15-15-16-xx-xx-xx-xx-xx-xx-57-61-61-61-61-61-61-61-60-xx-xx-14-15-15-15-15-15-15-16-xx-xx-xx-xx-xx-xx-xx-xx-xx-xx-xx-xx-xx-xx-xx-xx-xx-xx-xx-xx-xx-xx-xx-xx-xx-xx-xx-xx-xx-xx-xx-xx-xx-xx-xx-xx-xx-xx-xx-xx-xx-xx-xx-xx-xx-xx-xx-xx-xx-xx-xx-xx-xx-xx-xx-xx-xx-xx-xx-xx-xx-xx-xx-xx-xx-xx-xx-xx-xx-xx-xx-xx-xx-xx-xx-xx-xx-xx-xx-xx-xx-xx-xx-xx
xx-xx-xx-xx-xx-xx-xx-xx-xx-11-12-12-12-62-15-15-15-15-15-15-15-15-15-15-15-15-15-15-15-15-15-15-15-15-15-15-15-15-15-15-15-15-63-12-13-xx-xx-xx-xx-xx-xx-xx-xx-xx-xx-xx-xx-xx-14-15-15-15-15-15-63-12-12-12-12-12-12-12-12-12-12-12-12-62-15-16-xx-xx-xx-xx-xx-xx-xx-xx-xx-xx-xx-xx-xx-xx-xx-11-12-13-xx-xx-xx-xx-xx-xx-xx-xx-xx-xx-xx-xx-xx-xx-xx-xx-xx-xx-xx-xx-11-12-62-15-15-16-xx-xx-xx-xx-xx-xx-xx-xx-xx-xx-xx-xx-xx-xx-xx-xx-xx-14-15-15-15-15-15-15-15-12-12-12-12-13-xx-xx-12-12-12-12-12-xx-xx-xx-xx-xx-xx-xx-xx-xx-xx-xx-xx-xx-xx-xx-xx-xx-xx-11-12-13-xx-xx-xx-xx-xx-xx-xx-xx-xx-xx-xx-xx-xx-xx-xx-xx-xx-xx-xx-xx-xx-xx-xx-xx-xx-xx-xx-xx-xx-xx-xx-xx-xx-xx-xx-xx-xx-xx-xx-xx-xx-xx-xx-xx-xx-xx-xx-xx-xx-xx-xx
11-12-12-12-12-12-12-12-12-62-15-15-15-15-15-15-15-15-15-15-15-15-15-15-15-15-15-15-15-15-15-15-15-15-15-15-15-15-15-15-15-15-15-15-63-12-12-12-13-xx-xx-xx-xx-xx-xx-xx-xx-xx-14-15-15-15-15-15-15-15-15-15-15-15-15-15-15-15-15-15-15-15-15-16-xx-xx-xx-xx-xx-xx-xx-xx-xx-xx-xx-xx-xx-xx-xx-14-15-16-xx-xx-xx-xx-xx-xx-xx-xx-xx-xx-xx-xx-xx-xx-xx-xx-xx-xx-xx-xx-14-15-15-15-15-16-xx-xx-xx-xx-xx-xx-xx-xx-xx-xx-xx-xx-xx-xx-xx-xx-11-62-15-15-15-15-15-15-63-15-15-15-15-16-xx-xx-14-15-15-15-15-xx-xx-xx-xx-xx-xx-xx-xx-xx-xx-11-12-12-12-12-12-12-12-62-15-63-12-12-12-12-12-12-12-12-12-12-12-12-12-12-12-12-12-12-12-12-12-12-12-12-12-12-12-12-12-12-12-12-12-12-12-12-12-12-13-xx-xx-xx-xx-xx-xx-xx-xx-xx-xx-xx-xx
14-15-15-15-15-15-15-15-15-15-15-15-15-15-15-15-15-15-15-15-15-15-15-15-15-15-15-15-15-15-15-15-15-15-15-15-15-15-15-15-15-15-15-15-15-15-15-15-16-xx-xx-11-12-12-12-12-12-12-62-15-15-15-15-15-15-15-15-15-15-15-15-15-15-15-15-15-15-15-15-63-12-12-12-12-12-12-12-12-12-12-12-12-12-12-12-62-15-63-12-12-12-12-12-12-12-12-12-12-12-12-12-12-12-12-12-12-12-12-62-15-15-15-15-63-12-12-12-12-12-12-12-12-12-12-12-12-12-12-12-12-62-15-15-15-15-15-15-15-15-15-15-15-15-16-xx-xx-14-15-15-15-63-12-12-12-12-12-12-12-12-12-12-62-15-15-15-15-15-15-15-15-15-15-15-15-15-15-15-15-15-15-15-15-15-15-15-15-15-15-15-15-15-15-15-15-15-15-15-15-15-15-15-15-15-15-15-15-15-15-15-15-16-xx-xx-11-12-12-12-12-12-12-12-12-12
14-15-15-15-15-15-15-15-15-15-15-15-15-15-15-15-15-15-15-15-15-15-15-15-15-15-15-15-15-15-15-15-15-15-15-15-15-15-15-15-15-15-15-15-15-15-15-15-16-xx-xx-14-15-15-15-15-15-15-15-15-15-15-15-15-15-15-15-15-15-15-15-15-15-15-15-15-15-15-15-15-15-15-15-15-15-15-15-15-15-15-15-15-15-15-15-15-15-15-15-15-15-15-15-15-15-15-15-15-15-15-15-15-15-15-15-15-15-15-15-15-15-15-15-15-15-15-15-15-15-15-15-15-15-15-15-15-15-15-15-15-15-15-15-15-15-15-15-15-15-15-15-15-15-16-xx-xx-14-15-15-15-15-15-15-15-15-15-15-15-15-15-15-15-15-15-15-15-15-15-15-15-15-15-15-15-15-15-15-15-15-15-15-15-15-15-15-15-15-15-15-15-15-15-15-15-15-15-15-15-15-15-15-15-15-15-15-15-15-15-15-15-16-xx-xx-14-15-15-15-15-15-15-15-15-15
14-15-15-15-15-15-15-15-15-15-15-15-15-15-15-15-15-15-15-15-15-15-15-15-15-15-15-15-15-15-15-15-15-15-15-15-15-15-15-15-15-15-15-15-15-15-15-15-16-xx-xx-14-15-15-15-15-15-15-15-15-15-15-15-15-15-15-15-15-15-15-15-15-15-15-15-15-15-15-15-15-15-15-15-15-15-15-15-15-15-15-15-15-15-15-15-15-15-15-15-15-15-15-15-15-15-15-15-15-15-15-15-15-15-15-15-15-15-15-15-15-15-15-15-15-15-15-15-15-15-15-15-15-15-15-15-15-15-15-15-15-15-15-15-15-15-15-15-15-15-15-15-15-15-16-xx-xx-14-15-15-15-15-15-15-15-15-15-15-15-15-15-15-15-15-15-15-15-15-15-15-15-15-15-15-15-15-15-15-15-15-15-15-15-15-15-15-15-15-15-15-15-15-15-15-15-15-15-15-15-15-15-15-15-15-15-15-15-15-15-15-15-16-xx-xx-14-15-15-15-15-15-15-15-15-15
14-15-15-15-15-15-15-15-15-15-15-15-15-15-15-15-15-15-15-15-15-15-15-15-15-15-15-15-15-15-15-15-15-15-15-15-15-15-15-15-15-15-15-15-15-15-15-15-16-xx-xx-14-15-15-15-15-15-15-15-15-15-15-15-15-15-15-15-15-15-15-15-15-15-15-15-15-15-15-15-15-15-15-15-15-15-15-15-15-15-15-15-15-15-15-15-15-15-15-15-15-15-15-15-15-15-15-15-15-15-15-15-15-15-15-15-15-15-15-15-15-15-15-15-15-15-15-15-15-15-15-15-15-15-15-15-15-15-15-15-15-15-15-15-15-15-15-15-15-15-15-15-15-15-16-xx-xx-14-15-15-15-15-15-15-15-15-15-15-15-15-15-15-15-15-15-15-15-15-15-15-15-15-15-15-15-15-15-15-15-15-15-15-15-15-15-15-15-15-15-15-15-15-15-15-15-15-15-15-15-15-15-15-15-15-15-15-15-15-15-15-15-16-xx-xx-14-15-15-15-15-15-15-15-15-15